year2,state,firms,estabs,emp,denom,estabs_entry,estabs_entry_rate,estabs_exit,estabs_exit_rate,job_creation,job_creation_births,job_creation_continuers,job_creation_rate_births,job_creation_rate,job_destruction,job_destruction_deaths,job_destruction_continuers,job_destruction_rate_deaths,job_destruction_rate,net_job_creation,net_job_creation_rate,reallocation_rate,d_flag,firmdeath_firms,firmdeath_estabs,firmdeath_emp
1977,1,52370,62851,957290,933906,10633,17.2,8057,13.1,191515,89862,101653,9.6,20.5,144746,58891,85855,6.3,15.5,46769,5,31,0,5623,5641,36602
1977,2,6479,7724,107155,108123,2028,27,1564,20.8,37545,19259,18286,17.8,34.7,39481,13504,25977,12.5,36.5,-1936,-1.8,69.4,0,1035,1039,6757
1977,4,36477,44113,604565,589412,9380,22,6229,14.6,147441,70660,76781,12,25,117136,45073,72063,7.6,19.9,30305,5.1,39.8,0,4333,4358,29117
1977,5,35497,40700,551097,529700,7291,18.3,5456,13.7,119728,44527,75201,8.4,22.6,76934,32541,44393,6.1,14.5,42794,8.1,29,0,3970,3994,19678
1977,6,362884,438763,6813612,6485221,88185,20.7,60589,14.2,1739471,779210,960261,12,26.8,1082690,488542,594148,7.5,16.7,656781,10.1,33.4,0,39700,39939,276726
1977,8,51640,60185,814072,786486,12873,22.2,8248,14.2,198230,93264,104966,11.9,25.2,143058,62313,80745,7.9,18.2,55172,7,36.4,0,5674,5695,37139
1977,9,53879,61410,1103826,1059984,9154,15.2,6634,11,214913,69925,144988,6.6,20.3,127228,47273,79955,4.5,12,87685,8.3,24,0,4248,4263,24208
1977,10,9917,11463,223122,220843,1954,17.6,1250,11.2,34819,14260,20559,6.5,15.8,30261,9058,21203,4.1,13.7,4558,2.1,27.4,0,807,810,5417
1977,11,13035,15049,297123,296361,2262,15.2,1857,12.5,59434,27830,31604,9.4,20.1,57910,20665,37245,7,19.5,1524,0.6,39,0,1131,1135,9899
1977,12,151967,182088,2418494,2316286,36817,20.7,27046,15.2,622795,319960,302835,13.8,26.9,418378,191983,226395,8.3,18.1,204417,8.8,36.2,0,19132,19236,120706
1977,13,78450,95912,1492869,1452440,17572,18.7,13164,14,319917,146749,173168,10.1,22,239058,97307,141751,6.7,16.5,80859,5.5,33,0,8877,8911,56643
1977,15,14785,17914,261107,253382,3306,19,2150,12.4,55585,27592,27993,10.9,21.9,40134,19811,20323,7.8,15.8,15451,6.1,31.6,0,1422,1438,10556
1977,16,16104,18789,259121,231418,3729,20.5,2500,13.7,92116,24359,67757,10.5,39.8,36709,15378,21331,6.6,15.9,55407,23.9,31.8,0,1738,1749,9788
1977,17,175556,204934,3918464,3811070,30779,15.2,25527,12.6,745771,293002,452769,7.7,19.6,530983,202056,328927,5.3,13.9,214788,5.7,27.8,0,16751,16871,107141
1977,18,79025,95184,1708861,1669809,14425,15.4,11452,12.2,298813,122017,176796,7.3,17.9,220708,81198,139510,4.9,13.2,78105,4.7,26.4,0,7440,7501,50290
1977,19,54752,64039,837719,809067,10153,16.1,7959,12.6,169102,68127,100975,8.4,20.9,111798,50697,61101,6.3,13.8,57304,7.1,27.6,0,5274,5295,31820
1977,20,44462,51779,683812,655543,8534,16.7,6944,13.6,159914,86834,73080,13.2,24.4,103375,44771,58604,6.8,15.8,56539,8.6,31.6,0,4707,4730,26873
1977,21,50185,58575,917801,886373,9714,16.8,7698,13.4,193739,73707,120032,8.3,21.9,130883,52485,78398,5.9,14.8,62856,7.1,29.6,0,5216,5228,31089
1977,22,58950,70027,1022019,992313,11804,17.3,8217,12,223323,96410,126913,9.7,22.5,163910,61748,102162,6.2,16.5,59413,6,33,0,5820,5853,37714
1977,23,18928,21672,292541,283886,3441,16.2,2749,12.9,59850,26990,32860,9.5,21.1,42539,16956,25583,6,15,17311,6.1,30,0,1756,1762,9457
1977,24,57553,68665,1126292,1112553,11007,16.4,8104,12,222714,87380,135334,7.9,20,195236,65771,129465,5.9,17.5,27478,2.5,35,0,5204,5225,33912
1977,25,93707,108717,1950802,1882042,14689,13.7,12039,11.2,389302,156490,232812,8.3,20.7,251781,104353,147428,5.5,13.4,137521,7.3,26.8,0,7821,7850,55400
1977,26,122825,147030,2717585,2620160,23171,16,18174,12.6,532685,198762,333923,7.6,20.3,337834,129387,208447,4.9,12.9,194851,7.4,25.8,0,11445,11517,71219
1977,27,65490,76962,1282741,1230881,12233,16.2,8978,11.9,282418,108556,173862,8.8,22.9,178697,73212,105485,5.9,14.5,103721,8.4,29,0,5779,5833,43594
1977,28,34771,40703,580955,560074,6881,17.2,5251,13.1,122791,48135,74656,8.6,21.9,81029,34704,46325,6.2,14.5,41762,7.4,29,0,3729,3755,22470
1977,29,79867,94773,1509440,1469021,15095,16.1,12458,13.3,297783,114468,183315,7.8,20.3,216945,89645,127300,6.1,14.8,80838,5.5,29.6,0,8281,8321,47534
1977,30,16631,18921,191002,178587,3669,20,2398,13.1,53807,23008,30799,12.9,30.1,28977,13324,15653,7.5,16.2,24830,13.9,32.4,0,1670,1675,9899
1977,31,31394,36094,473539,451669,5743,16.2,4373,12.3,116038,38504,77534,8.5,25.7,72297,29255,43042,6.5,16,43741,9.7,32,0,2972,2983,19664
1977,32,12870,14680,235286,224169,3257,23.1,2044,14.5,57167,24768,32399,11,25.5,34933,15357,19576,6.9,15.6,22234,9.9,31.2,0,1465,1469,9485
1977,33,16554,18450,262128,253779,3204,17.9,2063,11.5,51197,20146,31051,7.9,20.2,34498,14599,19899,5.8,13.6,16699,6.6,27.2,0,1400,1407,8623
1977,34,124633,141632,2300054,2259319,20677,14.8,17343,12.4,428173,178345,249828,7.9,19,346704,131638,215066,5.8,15.3,81469,3.7,30.6,0,11018,11061,64316
1977,35,20904,24176,274216,266414,4889,20.8,3459,14.7,67102,33274,33828,12.5,25.2,51497,22137,29360,8.3,19.3,15605,5.9,38.6,0,2422,2430,13635
1977,36,312235,353290,5537830,5436385,48066,13.7,44901,12.8,1044673,402056,642617,7.4,19.2,841782,323829,517953,6,15.5,202891,3.7,31,0,31295,31403,181812
1977,37,84507,102516,1749806,1718495,16733,16.7,12387,12.3,306568,132504,174064,7.7,17.8,243947,88082,155865,5.1,14.2,62621,3.6,28.4,0,8387,8415,51683
1977,38,13176,14915,149177,146556,2435,16.6,1871,12.8,29553,14237,15316,9.7,20.2,24311,10832,13479,7.4,16.6,5242,3.6,33.2,0,1170,1175,7566
1977,39,152023,189070,3540532,3435409,27568,14.8,21856,11.7,661824,255074,406750,7.4,19.3,451577,171061,280516,5,13.1,210247,6.2,26.2,0,13730,13816,90201
1977,40,50339,58474,746519,721672,10529,18.4,7817,13.7,165029,78339,86690,10.9,22.9,115335,50346,64989,7,16,49694,6.9,32,0,5627,5653,32516
1977,41,46561,53996,695635,671953,10968,20.9,7492,14.3,155622,71795,83827,10.7,23.2,108257,50465,57792,7.5,16.1,47365,7.1,32.2,0,4972,4997,30325
1977,42,174494,208706,3850164,3747434,28485,13.8,22690,11,710037,274156,435881,7.3,18.9,504578,183801,320777,4.9,13.5,205459,5.4,27,0,14434,14527,94368
1977,44,17572,19458,358023,324414,2770,14.4,2227,11.6,106312,18286,88026,5.6,32.8,39094,14848,24246,4.6,12.1,67218,20.7,24.2,0,1452,1462,7106
1977,45,42348,50173,839463,827934,8439,17.2,6095,12.4,136998,59754,77244,7.2,16.5,113939,41950,71989,5.1,13.8,23059,2.7,27.6,0,4204,4229,23887
1977,46,13879,15602,195298,171944,2501,16.2,2013,13.1,71785,25862,45923,15,41.7,25076,10499,14577,6.1,14.6,46709,27.1,29.2,0,1255,1255,6637
1977,47,65617,78341,1313540,1274018,13758,17.9,10116,13.2,267608,121527,146081,9.5,21,188564,74314,114250,5.8,14.8,79044,6.2,29.6,0,6942,6972,44067
1977,48,214503,263752,3989930,3845577,49801,19.4,34100,13.3,940636,434101,506535,11.3,24.5,651931,264041,387890,6.9,17,288705,7.5,34,0,23578,23753,157880
1977,49,21267,24552,356325,339645,5073,21.4,3305,14,92693,38733,53960,11.4,27.3,59333,26057,33276,7.7,17.5,33360,9.8,35,0,2148,2168,15845
1977,50,10484,11608,145065,139004,1914,16.9,1347,11.9,31309,13726,17583,9.9,22.5,19186,8799,10387,6.3,13.8,12123,8.7,27.6,0,910,913,4689
1977,51,72545,88147,1391291,1360438,14413,16.7,10723,12.4,282891,127383,155508,9.4,20.8,221186,79456,141730,5.8,16.3,61705,4.5,32.6,0,6987,7029,42992
1977,53,66225,77854,1027716,982291,15569,20.7,10117,13.4,242680,112304,130376,11.4,24.7,151829,65408,86421,6.7,15.5,90851,9.2,31,0,6567,6597,39560
1977,54,26551,30888,471881,459230,4781,15.7,3800,12.5,98603,41451,57152,9,21.5,73301,31646,41655,6.9,16,25302,5.5,32,0,2463,2478,13568
1977,55,75849,87655,1435114,1401103,13130,15.3,9808,11.4,238699,96694,142005,6.9,17,170676,69961,100715,5,12.2,68023,4.8,24.4,0,6219,6269,38462
1977,56,9659,10761,109296,102991,2260,21.9,1373,13.3,31497,15382,16115,14.9,30.6,18886,8866,10020,8.6,18.3,12611,12.3,36.6,0,926,928,6309
1978,1,54174,65108,1032099,994655,10270,16.1,7999,12.5,212992,71968,141024,7.2,21.4,138103,55212,82891,5.6,13.9,74889,7.5,27.8,0,5667,5688,30942
1978,2,6761,8011,110199,108594,1801,22.9,1484,18.9,35994,13070,22924,12,33.1,32784,15082,17702,13.9,30.2,3210,2.9,60.4,0,837,842,6987
1978,4,35145,43019,658018,630219,7741,17.8,8348,19.2,162964,60185,102779,9.5,25.9,107366,56864,50502,9,17,55598,8.9,34,0,4886,4932,28308
1978,5,33699,38928,563698,556481,5933,14.9,7207,18.1,107633,36143,71490,6.5,19.3,93199,47649,45550,8.6,16.7,14434,2.6,33.4,0,4418,4433,21665
1978,6,375039,452639,7242477,7022844,81029,18.2,66905,15,1681941,596236,1085705,8.5,23.9,1242674,528506,714168,7.5,17.7,439267,6.2,35.4,0,41451,41726,247950
1978,8,50217,59204,877235,843940,10786,18.1,11113,18.6,213410,73715,139695,8.7,25.3,146821,74935,71886,8.9,17.4,66589,7.9,34.8,0,6706,6740,38425
1978,9,55493,63206,1139561,1121611,8080,13,6272,10.1,192757,52558,140199,4.7,17.2,156857,63709,93148,5.7,14,35900,3.2,28,0,4291,4308,32288
1978,10,9702,11290,222745,222910,1458,12.8,1633,14.4,58786,9182,49604,4.1,26.4,59116,40838,18278,18.3,26.5,-330,-0.1,52.8,0,1231,1232,34224
1978,11,13238,15255,318271,307683,1953,12.9,1755,11.6,63264,17424,45840,5.7,20.6,42088,16725,25363,5.4,13.7,21176,6.9,27.4,0,1122,1138,8149
1978,12,159712,190769,2563045,2490498,35054,18.8,26328,14.1,619342,240341,379001,9.7,24.9,474247,190830,283417,7.7,19,145095,5.9,38,0,18884,18968,110615
1978,13,81030,98904,1615109,1554100,15561,16,12529,12.9,339942,115556,224386,7.4,21.9,217926,93061,124865,6,14,122016,7.9,28,0,8710,8748,52225
1978,15,15384,18555,275673,268386,2831,15.5,2190,12,56469,22285,34184,8.3,21,41894,20138,21756,7.5,15.6,14575,5.4,31.2,0,1405,1419,7582
1978,16,15630,18328,229888,243942,3061,16.5,3288,17.7,55171,21737,33434,8.9,22.6,83278,20769,62509,8.5,34.1,-28107,-11.5,45.2,0,1912,1921,9996
1978,17,178536,208469,4076306,3996893,27457,13.3,23997,11.6,711873,219005,492868,5.5,17.8,553047,201492,351555,5,13.8,158826,4,27.6,0,16386,16527,98512
1978,18,81028,97484,1829434,1768938,13091,13.6,10726,11.1,327945,89797,238148,5.1,18.5,206952,77825,129127,4.4,11.7,120993,6.8,23.4,0,7320,7361,40910
1978,19,56019,65581,875844,856636,9004,13.9,7426,11.5,158495,54655,103840,6.4,18.5,120078,41678,78400,4.9,14,38417,4.5,28,0,5339,5364,25468
1978,20,45720,53330,701242,691994,7858,15,6264,11.9,140239,51465,88774,7.4,20.3,121743,41566,80177,6,17.6,18496,2.7,35.2,0,4418,4431,23875
1978,21,51408,60194,958279,937876,9089,15.3,7408,12.5,184597,60768,123829,6.5,19.7,143791,60111,83680,6.4,15.3,40806,4.4,30.6,0,5233,5245,25056
1978,22,56700,68043,1108592,1062969,9458,13.7,10691,15.5,253707,74865,178842,7,23.9,162461,73187,89274,6.9,15.3,91246,8.6,30.6,0,6345,6371,36249
1978,23,19656,22501,309249,297059,3419,15.5,2532,11.5,62052,18992,43060,6.4,20.9,37671,14469,23202,4.9,12.7,24381,8.2,25.4,0,1807,1812,8329
1978,24,59011,70403,1174891,1150196,9597,13.8,7872,11.3,221233,69085,152148,6,19.2,171843,62953,108890,5.5,14.9,49390,4.3,29.8,0,5222,5244,29272
1978,25,95419,110493,2096054,2023236,13206,12,11449,10.4,398773,115069,283704,5.7,19.7,253137,110735,142402,5.5,12.5,145636,7.2,25,0,7618,7672,48507
1978,26,125934,150641,2886872,2793313,21114,14.2,17437,11.7,520781,167886,352895,6,18.6,333664,138798,194866,5,11.9,187117,6.7,23.8,0,11581,11637,69164
1978,27,67772,79549,1373082,1327845,11104,14.2,8497,10.9,285625,84549,201076,6.4,21.5,195150,67723,127427,5.1,14.7,90475,6.8,29.4,0,5872,5902,34322
1978,28,35073,41202,607547,594287,6181,15.1,5693,13.9,119943,42841,77102,7.2,20.2,93422,33973,59449,5.7,15.7,26521,4.5,31.4,0,3800,3811,17983
1978,29,81343,96708,1592243,1550739,14048,14.7,12017,12.6,309860,99151,210709,6.4,20,226851,93354,133497,6,14.6,83009,5.4,29.2,0,8269,8298,40906
1978,30,15955,18322,196897,193420,2891,15.5,3267,17.5,46743,16047,30696,8.3,24.2,39788,19624,20164,10.1,20.6,6955,3.6,41.2,0,1916,1920,9760
1978,31,32031,36884,481328,477311,4991,13.7,4157,11.4,98191,30052,68139,6.3,20.6,90157,33235,56922,7,18.9,8034,1.7,37.8,0,2951,2975,15148
1978,32,12569,14465,268248,251150,2840,19.5,2875,19.7,72689,24950,47739,9.9,28.9,38493,23286,15207,9.3,15.3,34196,13.6,30.6,0,1633,1637,11388
1978,33,17435,19434,295542,278719,3139,16.6,2141,11.3,65631,25431,40200,9.1,23.5,31985,13161,18824,4.7,11.5,33646,12,23,0,1528,1534,7214
1978,34,127076,144463,2402204,2348598,19063,13.3,16283,11.4,445590,137966,307624,5.9,19,338378,139935,198443,6,14.4,107212,4.6,28.8,0,10775,10816,58403
1978,35,19821,23243,293575,283040,3820,16.1,4419,18.6,73690,25656,48034,9.1,26,52619,29780,22839,10.5,18.6,21071,7.4,37.2,0,2715,2719,17516
1978,36,313051,353748,5768689,5663294,43729,12.4,43380,12.3,1102803,314998,787805,5.6,19.5,892013,353731,538282,6.2,15.8,210790,3.7,31.6,0,30834,30934,172097
1978,37,87639,106080,1852814,1798627,15733,15.1,12131,11.6,325017,107795,217222,6,18.1,216643,91546,125097,5.1,12,108374,6.1,24,0,8525,8561,43855
1978,38,13598,15373,162754,155928,2195,14.5,1709,11.3,33204,11301,21903,7.2,21.3,19552,8124,11428,5.2,12.5,13652,8.8,25,0,1189,1193,5327
1978,39,154883,192838,3665902,3601279,24420,12.8,20672,10.8,614607,177309,437298,4.9,17.1,485362,163548,321814,4.5,13.5,129245,3.6,27,0,13611,13668,71258
1978,40,47602,55990,775465,759436,8754,15.3,10543,18.4,163127,59586,103541,7.8,21.5,131069,71350,59719,9.4,17.3,32058,4.2,34.6,0,6344,6360,36622
1978,41,49107,56888,799227,747204,10761,19.4,7827,14.1,204994,69405,135589,9.3,27.4,100948,51979,48969,7,13.5,104046,13.9,27,0,5283,5301,27853
1978,42,176946,211626,3918722,3879480,25320,12,22356,10.6,694461,198858,495603,5.1,17.9,615976,235662,380314,6.1,15.9,78485,2,31.8,0,14774,14859,119049
1978,44,17895,19844,333538,345694,2501,12.7,2088,10.6,67605,20691,46914,6,19.6,91917,18484,73433,5.3,26.6,-24312,-7,39.2,0,1438,1440,7988
1978,45,43874,52114,913576,876031,8033,15.7,6096,11.9,173151,65063,108088,7.4,19.8,98061,39628,58433,4.5,11.2,75090,8.6,22.4,0,4392,4403,18593
1978,46,14362,16128,171114,182979,2418,15.2,1866,11.8,37404,12896,24508,7,20.4,61134,9110,52024,5,33.4,-23730,-13,40.8,0,1305,1306,5665
1978,47,67470,80428,1387433,1351188,12084,15.2,9966,12.6,272076,87952,184124,6.5,20.1,199587,78640,120947,5.8,14.8,72489,5.3,29.6,0,6950,6972,38450
1978,48,204014,254408,4209880,4089547,40560,15.7,46429,17.9,957291,326667,630624,8,23.4,716624,357494,359130,8.7,17.5,240667,5.9,35,0,26558,26702,174431
1978,49,20623,24014,376521,365325,4125,17,4355,17.9,85419,31886,53533,8.7,23.4,63026,31018,32008,8.5,17.3,22393,6.1,34.6,0,2401,2410,14870
1978,50,11075,12227,157568,151146,1915,16.1,1288,10.8,35944,13893,22051,9.2,23.8,23099,12244,10855,8.1,15.3,12845,8.5,30.6,0,961,968,4973
1978,51,75553,91696,1476718,1433574,13648,15.2,10060,11.2,286165,94211,191954,6.6,20,199877,82367,117510,5.7,13.9,86288,6.1,27.8,0,6879,6906,42338
1978,53,69560,81688,1199479,1113164,15036,18.8,11137,14,329618,104810,224808,9.4,29.6,156987,73594,83393,6.6,14.1,172631,15.5,28.2,0,7033,7057,40738
1978,54,26917,31302,453307,462115,4182,13.4,3756,12.1,72441,23492,48949,5.1,15.7,90059,24020,66039,5.2,19.5,-17618,-3.8,31.4,0,2478,2484,11280
1978,55,78838,91026,1545402,1489227,12528,14,9121,10.2,271175,83920,187255,5.6,18.2,158826,67552,91274,4.5,10.7,112349,7.5,21.4,0,6361,6389,34761
1978,56,9470,10634,124359,116515,1984,18.5,1971,18.4,37205,13911,23294,11.9,31.9,21517,12265,9252,10.5,18.5,15688,13.4,37,0,1179,1181,6070
1979,1,54740,65956,1082551,1055579,9429,14.4,8106,12.4,219059,74920,144139,7.1,20.8,165114,64732,100382,6.1,15.6,53945,5.2,31.2,0,5899,5914,35731
1979,2,7058,8303,107868,108810,1807,22.2,1398,17.1,28908,11662,17246,10.7,26.6,30793,12080,18713,11.1,28.3,-1885,-1.7,53.2,0,904,907,5560
1979,4,40312,48719,767836,713900,9218,20.1,3882,8.5,201655,75820,125835,10.6,28.2,93783,31146,62637,4.4,13.1,107872,15.1,26.2,0,118,132,1452
1979,5,36635,41975,602880,583718,6429,15.9,3659,9,113979,43564,70415,7.5,19.5,75654,22635,53019,3.9,13,38325,6.5,26,0,67,74,2254
1979,6,397916,478669,7909509,7568668,89959,19.3,60625,13,1856675,720036,1136639,9.5,24.5,1174992,475556,699436,6.3,15.5,681683,9,31,0,41904,42092,257486
1979,8,56439,65650,986371,932838,12099,19.4,6050,9.7,235069,89994,145075,9.6,25.2,128003,47807,80196,5.1,13.7,107066,11.5,27.4,0,106,123,3424
1979,9,56967,64834,1209947,1174179,7968,12.4,6032,9.4,199562,62615,136947,5.3,17,128026,45734,82292,3.9,10.9,71536,6.1,21.8,0,4160,4167,21983
1979,10,9929,11569,204698,213451,1551,13.6,1203,10.5,31881,11917,19964,5.6,14.9,49387,8173,41214,3.8,23.1,-17506,-8.2,29.8,0,809,820,3978
1979,11,13380,15433,345004,331429,1874,12.2,1607,10.5,64614,14861,49753,4.5,19.5,37464,15037,22427,4.5,11.3,27150,8.2,22.6,0,1053,1054,6545
1979,12,167424,200111,2783863,2670667,35985,18.4,25359,13,658780,266529,392251,10,24.7,432388,182845,249543,6.8,16.2,226392,8.5,32.4,0,18719,18824,114512
1979,13,82569,101420,1697563,1656127,15344,15.3,12251,12.2,328491,125754,202737,7.6,19.8,245618,89697,155921,5.4,14.8,82873,5,29.6,0,8777,8797,46769
1979,15,16176,19540,299448,287828,3146,16.5,2052,10.8,63981,24127,39854,8.4,22.2,40741,15616,25125,5.4,14.2,23240,8,28.4,0,1398,1407,8575
1979,16,17199,20004,273063,252533,3258,17,1729,9,78811,48419,30392,19.2,31.2,37750,11796,25954,4.7,14.9,41061,16.3,29.8,0,33,34,369
1979,17,179472,210286,4254550,4162321,26452,12.6,23368,11.2,749328,234048,515280,5.6,18,564871,212830,352041,5.1,13.6,184457,4.4,27.2,0,16189,16242,99206
1979,18,81915,98949,1890770,1858688,12617,12.8,10615,10.8,307539,95796,211743,5.2,16.5,243376,79544,163832,4.3,13.1,64163,3.4,26.2,0,7566,7599,41438
1979,19,55821,65560,917143,895752,7943,12.1,7598,11.6,158501,52484,106017,5.9,17.7,115718,45592,70126,5.1,12.9,42783,4.8,25.8,0,5486,5547,26840
1979,20,46258,54044,745742,722775,7216,13.4,6219,11.6,144860,46269,98591,6.4,20,98926,39884,59042,5.5,13.7,45934,6.3,27.4,0,4448,4460,22021
1979,21,52244,61395,1012738,984779,8594,14.1,7006,11.5,196521,67330,129191,6.8,20,140603,51844,88759,5.3,14.3,55918,5.7,28.6,0,5151,5164,29037
1979,22,62365,74252,1215507,1165151,11225,15.8,5512,7.7,260552,89321,171231,7.7,22.4,159840,50645,109195,4.3,13.7,100712,8.7,27.4,0,57,76,1700
1979,23,19869,22795,316786,312784,3047,13.5,2591,11.4,53556,19345,34211,6.2,17.1,45551,15107,30444,4.8,14.6,8005,2.5,29.2,0,1844,1850,8580
1979,24,60020,71895,1229447,1201416,9754,13.7,7883,11.1,222737,73443,149294,6.1,18.5,166675,65385,101290,5.4,13.9,56062,4.6,27.8,0,5445,5480,29949
1979,25,96896,112320,2205080,2149490,13250,11.9,10916,9.8,386725,115809,270916,5.4,18,275547,88524,187023,4.1,12.8,111178,5.2,25.6,0,7506,7533,45723
1979,26,127968,153288,3063605,2984910,20179,13.3,16679,11,509859,161024,348835,5.4,17.1,352469,126514,225955,4.2,11.8,157390,5.3,23.6,0,11511,11570,69149
1979,27,69380,81493,1472870,1422886,10832,13.5,8500,10.6,283390,91291,192099,6.4,19.9,183424,66120,117304,4.6,12.9,99966,7,25.8,0,5920,5940,33403
1979,28,36199,42574,646609,626892,6647,15.9,4992,11.9,130808,45443,85365,7.2,20.9,91374,34492,56882,5.5,14.6,39434,6.3,29.2,0,3734,3745,19545
1979,29,82474,98154,1681303,1635028,13324,13.7,11341,11.6,305814,94694,211120,5.8,18.7,213264,81579,131685,5,13,92550,5.7,26,0,7979,8040,43086
1979,30,17670,20088,228145,212853,3314,17.3,1689,8.8,58203,19207,38996,9,27.3,27619,8756,18863,4.1,13,30584,14.3,26,0,20,20,221
1979,31,32337,37235,500856,490679,4618,12.5,4047,10.9,92741,27842,64899,5.7,18.9,72387,22789,49598,4.6,14.8,20354,4.1,29.6,0,2796,2802,12552
1979,32,14672,16794,321765,295495,3559,22.8,1365,8.7,90270,38094,52176,12.9,30.5,37729,13000,24729,4.4,12.8,52541,17.7,25.6,0,90,91,842
1979,33,17923,20053,320709,307894,2937,14.9,2196,11.1,63490,19469,44021,6.3,20.6,37859,14011,23848,4.6,12.3,25631,8.3,24.6,0,1577,1583,7407
1979,34,130217,148058,2506400,2452931,19550,13.4,15091,10.3,449175,150546,298629,6.1,18.3,342238,121545,220693,5,14,106937,4.3,28,0,10295,10322,56858
1979,35,22017,25597,327893,311355,4479,18.3,2309,9.5,78403,31772,46631,10.2,25.2,45326,16743,28583,5.4,14.6,33077,10.6,29.2,0,36,41,832
1979,36,314400,355479,5898564,5829430,43023,12.1,39585,11.2,1017542,315374,702168,5.4,17.5,879274,308839,570435,5.3,15.1,138268,2.4,30.2,0,28952,29066,162536
1979,37,89363,108597,1968285,1909476,15059,14,11908,11.1,339345,115150,224195,6,17.8,221728,85982,135746,4.5,11.6,117617,6.2,23.2,0,8615,8635,44763
1979,38,13969,15784,177608,169999,2266,14.5,1732,11.1,39204,14509,24695,8.5,23.1,23986,9426,14560,5.5,14.1,15218,9,28.2,0,1246,1247,6591
1979,39,156866,195635,3835606,3748563,23969,12.3,20220,10.4,624870,198439,426431,5.3,16.7,450784,168047,282737,4.5,12,174086,4.7,24,0,13349,13401,75469
1979,40,52569,61407,866880,822197,9990,17,4991,8.5,196756,71567,125189,8.7,23.9,107390,36977,70413,4.5,13.1,89366,10.8,26.2,0,91,98,1235
1979,41,51136,59297,871803,834057,10755,18.5,7873,13.6,213411,72451,140960,8.7,25.6,137919,52839,85080,6.3,16.5,75492,9.1,33,0,5680,5688,30102
1979,42,178610,214383,4008476,3961443,24802,11.6,21000,9.9,639039,189474,449565,4.8,16.1,544975,174865,370110,4.4,13.8,94064,2.3,27.6,0,14392,14463,78769
1979,44,18272,20279,342200,337713,2454,12.2,1919,9.6,58066,18718,39348,5.5,17.2,49092,14366,34726,4.3,14.5,8974,2.7,29,0,1340,1342,7370
1979,45,44355,53019,963565,938993,7385,14,6156,11.7,163566,51763,111803,5.5,17.4,114421,38289,76132,4.1,12.2,49145,5.2,24.4,0,4523,4557,22195
1979,46,14553,16413,185558,178124,2254,13.9,1867,11.5,39491,14841,24650,8.3,22.2,24622,9900,14722,5.6,13.8,14869,8.4,27.6,0,1327,1328,6139
1979,47,68319,81799,1458548,1421801,11998,14.8,10104,12.5,274886,96562,178324,6.8,19.3,201392,72815,128577,5.1,14.2,73494,5.1,28.4,0,7187,7199,38245
1979,48,228578,282027,4678309,4451915,47563,17.7,22226,8.3,1091347,419761,671586,9.4,24.5,638559,199536,439023,4.5,14.3,452788,10.2,28.6,0,308,381,9442
1979,49,23104,26717,412765,395108,4557,18,2026,8,91838,37072,54766,9.4,23.2,56524,17725,38799,4.5,14.3,35314,8.9,28.6,0,37,41,650
1979,50,11342,12557,164290,160801,1754,14.2,1360,11,30229,10358,19871,6.4,18.8,23250,8177,15073,5.1,14.5,6979,4.3,29,0,1040,1046,5397
1979,51,77093,93960,1550702,1512693,13103,14.1,10379,11.2,287146,99284,187862,6.6,19,211127,73675,137452,4.9,14,76019,5,28,0,7399,7422,37383
1979,53,72955,85377,1217909,1207023,15288,18.3,10892,13,287274,104453,182821,8.7,23.8,265501,98856,166645,8.2,22,21773,1.8,44,0,7480,7512,40436
1979,54,27286,31833,527496,489847,4355,13.8,3578,11.3,132816,29320,103496,6,27.1,57518,20797,36721,4.2,11.7,75298,15.4,23.4,0,2529,2536,10888
1979,55,80153,92771,1621788,1583427,11373,12.4,9200,10,260102,82898,177204,5.2,16.4,183381,63675,119706,4,11.6,76721,4.8,23.2,0,6444,6463,33301
1979,56,10657,11918,139402,132072,2226,19.7,1015,9,35934,15539,20395,11.8,27.2,21273,6545,14728,5,16.1,14661,11.1,32.2,0,25,26,272
1980,1,54507,65854,1080425,1080568,8630,13.1,8429,12.8,179438,61158,118280,5.7,16.6,179725,58060,121665,5.4,16.6,-287,0,33.2,0,6072,6086,33755
1980,2,7080,8329,108387,107906,1477,17.8,1347,16.2,24364,8920,15444,8.3,22.6,23402,7889,15513,7.3,21.7,962,0.9,43.4,0,886,892,4606
1980,4,42353,51123,801825,784121,9369,18.8,6660,13.3,172601,72269,100332,9.2,22,137193,48653,88540,6.2,17.5,35408,4.5,35,0,4764,4776,28768
1980,5,36611,41953,619928,611113,5632,13.4,5457,13,112208,36101,76107,5.9,18.4,94578,31904,62674,5.2,15.5,17630,2.9,31,0,3971,3981,17746
1980,6,411297,494138,8243332,8071049,81835,16.8,63885,13.1,1724557,662476,1062081,8.2,21.4,1379990,510047,869943,6.3,17.1,344567,4.3,34.2,0,44376,44586,281614
1980,8,58289,67714,1021224,1002032,11811,17.7,9311,14,211043,84847,126196,8.5,21.1,172659,72879,99780,7.3,17.2,38384,3.9,34.4,0,6584,6608,42272
1980,9,57618,65660,1252662,1230108,7588,11.6,6536,10,193568,61287,132281,5,15.7,148459,47926,100533,3.9,12.1,45109,3.6,24.2,0,4555,4596,23570
1980,10,9960,11553,210932,207717,1336,11.6,1316,11.4,31107,10687,20420,5.1,15,24677,9206,15471,4.4,11.9,6430,3.1,23.8,0,887,912,4646
1980,11,13579,15609,356697,350546,1881,12.1,1681,10.8,76569,16865,59704,4.8,21.8,64266,30157,34109,8.6,18.3,12303,3.5,36.6,0,1095,1099,7388
1980,12,175449,209299,2967576,2876515,36294,17.7,26347,12.9,654151,280362,373789,9.7,22.7,472028,187912,284116,6.5,16.4,182123,6.3,32.8,0,19499,19564,116237
1980,13,83550,102689,1738458,1717722,14164,13.9,12511,12.3,304903,112803,192100,6.6,17.8,263431,94098,169333,5.5,15.3,41472,2.5,30.6,0,8830,8872,47751
1980,15,16928,20428,304306,301662,3133,15.7,2175,10.9,54540,23273,31267,7.7,18.1,49252,17010,32242,5.6,16.3,5288,1.8,32.6,0,1460,1474,9700
1980,16,17303,20153,247846,260273,3034,15.1,2750,13.7,48433,18253,30180,7,18.6,73286,17393,55893,6.7,28.2,-24853,-9.6,37.2,0,1959,1967,9969
1980,17,179911,211102,4183504,4217678,24986,11.9,23577,11.2,586098,215886,370212,5.1,13.9,654447,198857,455590,4.7,15.5,-68349,-1.6,27.8,0,16442,16528,94862
1980,18,81885,99144,1835091,1861559,11526,11.6,10941,11,251818,93213,158605,5,13.5,304755,81454,223301,4.4,16.4,-52937,-2.9,27,0,7643,7678,39268
1980,19,55744,65655,910446,912862,7596,11.6,7178,10.9,135216,49534,85682,5.4,14.8,140048,48068,91980,5.3,15.3,-4832,-0.5,29.6,0,5314,5327,28356
1980,20,46259,54104,754768,749677,6614,12.2,6337,11.7,123771,44312,79459,5.9,16.5,113588,35520,78068,4.7,15.2,10183,1.3,30.4,0,4533,4544,22545
1980,21,51794,61164,1006243,1008844,7352,12,7328,12,155739,54317,101422,5.4,15.4,160940,47011,113929,4.7,16,-5201,-0.6,30.8,0,5357,5373,27406
1980,22,63540,75734,1247934,1230751,10605,14.1,8773,11.7,244016,84526,159490,6.9,19.8,209650,67602,142048,5.5,17,34366,2.8,34,0,6320,6352,39622
1980,23,19755,22728,318499,317263,2767,12.2,2669,11.7,50046,16871,33175,5.3,15.8,47574,16746,30828,5.3,15,2472,0.8,30,0,1847,1858,8536
1980,24,60818,72824,1297639,1264918,9130,12.6,8026,11.1,251882,102979,148903,8.1,19.9,186439,60634,125805,4.8,14.7,65443,5.2,29.4,0,5417,5452,31888
1980,25,97757,113339,2275717,2240113,12454,11,11065,9.8,373633,108466,265167,4.8,16.7,302426,100622,201804,4.5,13.5,71207,3.2,27,0,7517,7569,48711
1980,26,127746,153752,2884492,2970675,18601,12.1,17454,11.4,375656,145216,230440,4.9,12.6,548022,141689,406333,4.8,18.4,-172366,-5.8,25.2,0,12020,12061,67331
1980,27,70290,82639,1498449,1485092,9966,12.1,8541,10.4,244239,83873,160366,5.6,16.4,217526,72371,145155,4.9,14.6,26713,1.8,29.2,0,5943,5982,39022
1980,28,36522,43031,644585,645453,5798,13.5,5163,12.1,104381,39130,65251,6.1,16.2,106116,34627,71489,5.4,16.4,-1735,-0.2,32.4,0,3773,3796,19808
1980,29,82341,98096,1672016,1675551,11976,12.2,11547,11.8,254673,90438,164235,5.4,15.2,261742,84184,177558,5,15.6,-7069,-0.4,30.4,0,8152,8175,41837
1980,30,17716,20122,218673,223353,2881,14.3,2704,13.5,37996,16544,21452,7.4,17,47355,14751,32604,6.6,21.2,-9359,-4.2,34,0,1871,1877,9336
1980,31,32401,37357,512626,506227,4431,11.9,4154,11.1,85900,29418,56482,5.8,17,73101,23292,49809,4.6,14.4,12799,2.6,28.8,0,2975,2984,14816
1980,32,15349,17628,339259,329616,3424,19.9,2476,14.4,78567,32604,45963,9.9,23.8,59281,22959,36322,7,18,19286,5.8,36,0,1794,1801,16658
1980,33,18008,20168,328102,324251,2555,12.7,2334,11.6,55436,18453,36983,5.7,17.1,47734,17544,30190,5.4,14.7,7702,2.4,29.4,0,1673,1680,9598
1980,34,132229,150353,2544337,2525043,18197,12.2,15533,10.4,410594,136036,274558,5.4,16.3,372005,118892,253113,4.7,14.7,38589,1.6,29.4,0,10875,10916,57554
1980,35,22405,26027,329497,328118,4232,16.4,3553,13.8,67547,29283,38264,8.9,20.6,64789,24492,40297,7.5,19.7,2758,0.9,39.4,0,2525,2529,14673
1980,36,314756,355771,5967052,5917363,40390,11.4,39225,11,967442,314265,653177,5.3,16.3,868063,299760,568303,5.1,14.7,99379,1.6,29.4,0,28818,28890,158956
1980,37,89888,109508,1999791,1987793,13833,12.7,12450,11.4,295257,100195,195062,5,14.9,271261,86637,184624,4.4,13.6,23996,1.3,27.2,0,8890,8928,49232
1980,38,14083,15980,183099,180107,2066,13,1796,11.3,33532,13222,20310,7.3,18.6,27547,9864,17683,5.5,15.3,5985,3.3,30.6,0,1278,1279,6586
1980,39,156816,196046,3776304,3804434,21704,11.1,20489,10.5,521503,180741,340762,4.8,13.7,577762,163193,414569,4.3,15.2,-56259,-1.5,27.4,0,13738,13828,75324
1980,40,53632,62690,907304,885667,9559,15.4,7965,12.8,189486,76777,112709,8.7,21.4,146211,50040,96171,5.6,16.5,43275,4.9,33,0,5882,5909,30204
1980,41,51985,60350,854769,862668,9945,16.6,8603,14.4,163267,67750,95517,7.9,18.9,179065,56748,122317,6.6,20.8,-15798,-1.9,37.8,0,6111,6142,33183
1980,42,178050,214154,4034518,4023937,22725,10.6,22074,10.3,580109,194653,385456,4.8,14.4,558947,187083,371864,4.6,13.9,21162,0.5,27.8,0,15214,15277,86745
1980,44,18312,20296,340579,340732,2176,10.7,2090,10.3,47729,15152,32577,4.4,14,48034,13739,34295,4,14.1,-305,-0.1,28,0,1458,1459,7406
1980,45,44828,53663,970642,966652,7191,13.5,6322,11.9,143985,52357,91628,5.4,14.9,136005,42770,93235,4.4,14.1,7980,0.8,28.2,0,4506,4523,21057
1980,46,14644,16532,186819,186133,2055,12.5,1861,11.3,31107,12902,18205,6.9,16.7,29735,10454,19281,5.6,16,1372,0.7,32,0,1364,1368,6774
1980,47,68644,82393,1435307,1446071,11084,13.5,10167,12.4,224413,85396,139017,5.9,15.5,245940,77249,168691,5.3,17,-21527,-1.5,31,0,7237,7252,39821
1980,48,197685,252871,4643565,4605329,28133,10.5,41041,15.4,899014,272792,626222,5.9,19.5,822541,325548,496993,7.1,17.9,76473,1.6,35.8,0,30408,30581,192868
1980,49,23147,26906,420985,416185,4212,15.7,3807,14.2,81479,32842,48637,7.9,19.6,71880,27364,44516,6.6,17.3,9599,2.3,34.6,0,2679,2695,15646
1980,50,11514,12750,169637,166940,1650,13,1397,11,28962,9108,19854,5.5,17.3,23568,7223,16345,4.3,14.1,5394,3.2,28.2,0,1056,1058,4549
1980,51,77923,95152,1590041,1569312,12445,13.2,10827,11.5,260138,91874,168264,5.9,16.6,218681,70632,148049,4.5,13.9,41457,2.7,27.8,0,7573,7604,37651
1980,53,73963,86774,1258086,1236743,13672,15.9,11660,13.5,258160,93810,164350,7.6,20.9,215476,75091,140385,6.1,17.4,42684,3.5,34.8,0,8098,8126,43343
1980,54,27157,31780,486991,506933,3742,11.8,3670,11.5,71185,26326,44859,5.2,14,111071,24670,86401,4.9,21.9,-39886,-7.9,28,0,2621,2630,12632
1980,55,80369,93213,1617996,1618565,10359,11.1,9543,10.3,212634,73689,138945,4.6,13.1,213772,66085,147687,4.1,13.2,-1138,-0.1,26.2,0,6749,6781,35373
1980,56,10949,12307,147824,143420,2088,17.2,1610,13.3,34331,13712,20619,9.6,23.9,25523,9647,15876,6.7,17.8,8808,6.1,35.6,0,1172,1175,6648
1981,1,52537,63472,1039605,1049621,7958,12.3,9393,14.6,174471,71065,103406,6.8,16.6,194504,78574,115930,7.5,18.5,-20033,-1.9,33.2,0,6056,6081,37042
1981,2,7103,8280,111596,106843,1483,17.9,1346,16.3,30351,11891,18460,11.1,28.4,20845,9003,11842,8.4,19.5,9506,8.9,39,0,748,750,4444
1981,4,42386,51297,805602,796818,8972,17.5,8213,16.1,165420,69680,95740,8.7,20.8,147852,57938,89914,7.3,18.6,17568,2.2,37.2,0,5241,5257,30259
1981,5,35020,40299,576396,583104,5437,13.3,6135,15,94600,45053,49547,7.7,16.2,108016,37322,70694,6.4,18.5,-13416,-2.3,32.4,0,4014,4028,19401
1981,6,408296,488881,8250467,8216484,76970,15.7,77394,15.8,1702220,697924,1004296,8.5,20.7,1634253,664121,970132,8.1,19.9,67967,0.8,39.8,0,45631,45870,290588
1981,8,57790,67246,1033738,1018127,11493,17.1,11251,16.7,234518,100359,134159,9.9,23,203295,86924,116371,8.5,20,31223,3,40,0,7007,7038,45848
1981,9,56440,64128,1240056,1238902,7361,11.4,8281,12.8,178187,69959,108228,5.6,14.4,175879,67750,108129,5.5,14.2,2308,0.2,28.4,0,4738,4744,25687
1981,10,9711,11256,213163,211691,1287,11.3,1491,13.1,31803,12430,19373,5.9,15,28858,10638,18220,5,13.6,2945,1.4,27.2,0,839,842,4517
1981,11,13125,15045,340116,350933,1780,11.6,2197,14.4,59004,25205,33799,7.2,16.8,80639,50746,29893,14.5,23,-21635,-6.2,33.6,0,1185,1190,12551
1981,12,178229,212415,3093328,3023130,36194,17.2,31416,14.9,693224,286376,406848,9.5,22.9,552828,233028,319800,7.7,18.3,140396,4.6,36.6,0,20615,20707,120733
1981,13,81996,100924,1728952,1720604,13766,13.6,14436,14.2,324726,131926,192800,7.7,18.9,308030,123929,184101,7.2,17.9,16696,1,35.8,0,8849,8871,48310
1981,15,17068,20401,308153,305250,3004,14.7,2853,14,57564,27120,30444,8.9,18.9,51757,20992,30765,6.9,17,5807,1.9,34,0,1700,1733,10583
1981,16,16458,19220,255991,249835,2661,13.6,3213,16.4,60791,36105,24686,14.5,24.3,48478,18646,29832,7.5,19.4,12313,4.9,38.8,0,2057,2077,9980
1981,17,173456,203354,3963548,4025230,23353,11.3,28363,13.7,576861,226327,350534,5.6,14.3,700226,262965,437261,6.5,17.4,-123365,-3.1,28.6,0,16411,16530,109080
1981,18,78574,95257,1739703,1765161,10362,10.7,13032,13.5,248734,95733,153001,5.4,14.1,299651,107002,192649,6.1,17,-50917,-2.9,28.2,0,7689,7724,41916
1981,19,53753,63443,858521,873079,7022,10.9,8528,13.3,134191,67640,66551,7.7,15.4,163306,64606,98700,7.4,18.7,-29115,-3.3,30.8,0,5316,5338,25683
1981,20,45121,52694,749232,745440,6698,12.6,7471,14,132788,55112,77676,7.4,17.8,125203,47574,77629,6.4,16.8,7585,1,33.6,0,4605,4625,24088
1981,21,49845,58904,937976,947763,6989,11.7,8228,13.8,148958,58778,90180,6.2,15.7,168532,59124,109408,6.2,17.8,-19574,-2.1,31.4,0,5101,5118,26947
1981,22,63328,75341,1285030,1260827,10616,14.1,10238,13.6,266713,102189,164524,8.1,21.2,218306,81922,136384,6.5,17.3,48407,3.9,34.6,0,6453,6491,39080
1981,23,19124,21979,312617,311981,2595,11.6,3009,13.5,51676,17460,34216,5.6,16.6,50404,21246,29158,6.8,16.2,1272,0.4,32.4,0,1849,1858,8441
1981,24,59722,71454,1259431,1274202,8893,12.3,9807,13.6,214056,86128,127928,6.8,16.8,243598,85856,157742,6.7,19.1,-29542,-2.3,33.6,0,5568,5591,32202
1981,25,96207,111358,2254970,2258237,12140,10.8,13262,11.8,365386,124323,241063,5.5,16.2,371921,155893,216028,6.9,16.5,-6535,-0.3,32.4,0,7436,7478,57603
1981,26,123239,147897,2740390,2803016,17058,11.3,21371,14.2,386461,164917,221544,5.9,13.8,511712,185136,326576,6.6,18.3,-125251,-4.5,27.6,0,12000,12080,65260
1981,27,68792,80776,1455153,1463745,9426,11.6,10283,12.6,236325,98680,137645,6.7,16.1,253508,96612,156896,6.6,17.3,-17183,-1.2,32.2,0,5945,5974,41864
1981,28,35094,41403,596929,601751,5055,12,6049,14.4,94516,36426,58090,6.1,15.7,104160,36757,67403,6.1,17.3,-9644,-1.6,31.4,0,3941,3949,19855
1981,29,79610,94727,1606888,1617658,11591,12.1,13577,14.1,249434,101820,147614,6.3,15.4,270975,104283,166692,6.4,16.8,-21541,-1.4,30.8,0,8125,8152,41886
1981,30,17096,19400,199564,200389,2737,14,2913,14.9,38018,15819,22199,7.9,19,39668,17175,22493,8.6,19.8,-1650,-0.8,38,0,1814,1814,9491
1981,31,30843,35575,482167,481195,4086,11.3,4783,13.3,80149,32816,47333,6.8,16.7,78205,31634,46571,6.6,16.3,1944,0.4,32.6,0,2813,2818,13933
1981,32,15350,17684,331837,334378,3231,18.3,2969,16.8,70001,30703,39298,9.2,20.9,75082,28131,46951,8.4,22.5,-5081,-1.6,41.8,0,1861,1865,11907
1981,33,17552,19669,318581,317166,2592,13.1,2705,13.7,57850,21463,36387,6.8,18.2,55020,23388,31632,7.4,17.3,2830,0.9,34.6,0,1637,1640,9206
1981,34,129541,147091,2525170,2514614,17234,11.6,19125,12.9,427668,164353,263315,6.5,17,406557,166293,240264,6.6,16.2,21111,0.8,32.4,0,11363,11405,58818
1981,35,22016,25524,328578,325772,3920,15.2,4102,15.9,71388,29963,41425,9.2,21.9,65776,27958,37818,8.6,20.2,5612,1.7,40.4,0,2629,2639,15593
1981,36,307264,346561,5836639,5863075,38954,11.1,45617,13,958476,342824,615652,5.8,16.3,1011348,402960,608388,6.9,17.2,-52872,-0.9,32.6,0,28457,28582,155857
1981,37,87819,107167,1971468,1969863,13276,12.3,14696,13.6,302526,115719,186807,5.9,15.4,299317,117657,181660,6,15.2,3209,0.2,30.4,0,9063,9091,49490
1981,38,13540,15451,169676,170069,1970,12.7,2034,13.1,28944,13143,15801,7.7,17,29729,10837,18892,6.4,17.5,-785,-0.5,34,0,1252,1253,6111
1981,39,151549,189364,3538704,3614763,20372,10.6,25130,13.1,463854,188564,275290,5.2,12.8,615972,221202,394770,6.1,17,-152118,-4.2,25.6,0,13902,13974,77304
1981,40,53259,62100,916920,895255,9577,15.4,9210,14.8,193084,78769,114315,8.8,21.6,149754,64887,84867,7.2,16.7,43330,4.9,33.4,0,6098,6113,32564
1981,41,50418,58542,797176,813333,9000,15.2,9892,16.7,136960,66441,70519,8.2,16.8,169274,66911,102363,8.2,20.8,-32314,-4,33.6,0,6146,6168,34569
1981,42,170995,206128,3970075,3990867,20907,10,26648,12.7,580831,230435,350396,5.8,14.6,622415,229389,393026,5.7,15.6,-41584,-1,29.2,0,15340,15409,89073
1981,44,17844,19788,334633,337112,2141,10.7,2490,12.4,50089,19015,31074,5.6,14.9,55047,21071,33976,6.3,16.3,-4958,-1.4,29.8,0,1480,1484,8297
1981,45,43454,52248,950030,952413,6751,12.8,7636,14.5,142797,57347,85450,6,15,147562,58334,89228,6.1,15.5,-4765,-0.5,30,0,4655,4672,26164
1981,46,13978,15797,169100,171545,1766,11,2153,13.4,24814,11152,13662,6.5,14.5,29703,11471,18232,6.7,17.3,-4889,-2.8,29,0,1332,1336,6566
1981,47,66185,79678,1398718,1402963,10106,12.5,11610,14.4,228259,88057,140202,6.3,16.3,236748,89822,146926,6.4,16.9,-8489,-0.6,32.6,0,7417,7446,41706
1981,48,235061,290998,5037911,4881418,52881,19.5,34909,12.9,1099166,501831,597335,10.3,22.5,786182,310522,475660,6.4,16.1,312984,6.4,32.2,0,19813,19914,130920
1981,49,22651,26560,416677,416652,4220,15.8,4266,16,79898,36516,43382,8.8,19.2,79847,33280,46567,8,19.2,51,0,38.4,0,2642,2654,16753
1981,50,11047,12245,161841,161312,1529,12.4,1688,13.6,25156,8860,16296,5.5,15.6,24097,9342,14755,5.8,14.9,1059,0.7,29.8,0,1057,1061,5075
1981,51,76142,93275,1599052,1584952,12066,12.8,13077,13.9,286011,121100,164911,7.6,18,257811,111750,146061,7.1,16.3,28200,1.7,32.6,0,7760,7808,46490
1981,53,72260,84933,1219064,1222822,12593,14.7,13206,15.4,230928,97474,133454,8,18.9,238444,88118,150326,7.2,19.5,-7516,-0.6,37.8,0,7887,7921,41061
1981,54,26000,30607,468718,472597,3614,11.6,4381,14.1,70628,29849,40779,6.3,14.9,78386,28865,49521,6.1,16.6,-7758,-1.7,29.8,0,2784,2787,13077
1981,55,78246,90685,1537146,1562996,9717,10.6,11334,12.4,202631,83988,118643,5.4,13,254333,82699,171634,5.3,16.3,-51702,-3.3,26,0,6512,6536,33536
1981,56,11026,12416,152505,149256,2127,17.2,1892,15.3,37012,14593,22419,9.8,24.8,30514,11473,19041,7.7,20.4,6498,4.4,40.8,0,1229,1232,6489
1982,1,51522,63543,1031522,1034805,8797,13.8,7909,12.4,176891,74493,102398,7.2,17.1,183457,61139,122318,5.9,17.7,-6566,-0.6,34.2,0,4766,4769,27066
1982,2,7773,9205,126518,118838,2065,23.6,1107,12.6,40830,17321,23509,14.6,34.4,25469,9800,15669,8.2,21.4,15361,13,42.8,0,578,581,5328
1982,4,44297,54693,817640,810238,11013,20.8,7183,13.5,183305,96941,86364,12,22.6,168500,56239,112261,6.9,20.8,14805,1.8,41.6,0,3978,3985,23435
1982,5,34932,40901,573775,574573,6290,15.5,5166,12.7,99745,43592,56153,7.6,17.4,101341,33044,68297,5.8,17.6,-1596,-0.2,34.8,0,3056,3060,16433
1982,6,416191,507992,8504517,8369918,87504,17.5,63148,12.7,1868288,885107,983181,10.6,22.3,1599091,528107,1070984,6.3,19.1,269197,3.2,38.2,0,34912,34957,231305
1982,8,60029,71115,1126308,1079634,13916,20.1,9434,13.6,290178,159926,130252,14.8,26.9,196830,76711,120119,7.1,18.2,93348,8.7,36.4,0,5139,5143,32230
1982,9,57542,66275,1259365,1249422,8939,13.7,6250,9.6,194097,85599,108498,6.9,15.5,174211,51052,123159,4.1,13.9,19886,1.6,27.8,0,3650,3654,22434
1982,10,9916,11553,216011,214421,1581,13.9,1181,10.4,30498,13376,17122,6.2,14.2,27318,8779,18539,4.1,12.7,3180,1.5,25.4,0,654,658,3178
1982,11,13530,15588,335672,337863,2399,15.7,1742,11.4,60362,32007,28355,9.5,17.9,64744,18907,45837,5.6,19.2,-4382,-1.3,35.8,0,895,899,7992
1982,12,185530,224969,3140616,3115382,41939,19.2,27840,12.7,681328,328809,352519,10.6,21.9,630861,207889,422972,6.7,20.2,50467,1.7,40.4,0,16538,16564,107803
1982,13,82632,103584,1766506,1746103,16171,15.8,12488,12.2,333461,164904,168557,9.4,19.1,292655,98123,194532,5.6,16.8,40806,2.3,33.6,0,6852,6857,42437
1982,15,17268,21087,314115,311210,3299,15.9,2385,11.5,60819,33814,27005,10.9,19.5,55009,18885,36124,6.1,17.7,5810,1.8,35.4,0,1355,1355,8403
1982,16,16466,19542,243125,249220,3172,16.4,2593,13.4,53423,33570,19853,13.5,21.4,65613,15809,49804,6.3,26.3,-12190,-4.9,42.8,0,1410,1411,7459
1982,17,174325,207473,3891108,3926689,28330,13.8,22366,10.9,607297,290029,317268,7.4,15.5,678458,206661,471797,5.3,17.3,-71161,-1.8,31,0,12812,12832,79519
1982,18,78795,97062,1703197,1721423,12703,13.2,10129,10.5,236038,104257,131781,6.1,13.7,272491,76070,196421,4.4,15.8,-36453,-2.1,27.4,0,6023,6043,33776
1982,19,52341,62926,868365,862691,7827,12.4,7266,11.5,156286,66344,89942,7.7,18.1,144940,45349,99591,5.3,16.8,11346,1.3,33.6,0,4287,4288,20736
1982,20,45111,53513,746548,747358,7788,14.7,6272,11.8,120644,57129,63515,7.6,16.1,122263,43723,78540,5.9,16.4,-1619,-0.3,32.2,0,3726,3748,22223
1982,21,50099,60160,946083,941558,8819,14.8,6921,11.6,163898,73806,90092,7.8,17.4,154850,47197,107653,5,16.4,9048,1,32.8,0,4166,4169,21657
1982,22,65762,79321,1316595,1299399,13253,17.1,8666,11.2,276428,115725,160703,8.9,21.3,242035,82851,159184,6.4,18.6,34393,2.7,37.2,0,4926,4943,38900
1982,23,19075,22259,313927,312910,3021,13.7,2478,11.2,52874,24416,28458,7.8,16.9,50839,19412,31427,6.2,16.2,2035,0.7,32.4,0,1444,1451,9929
1982,24,60824,74001,1278562,1269170,10860,14.9,7704,10.6,227343,105052,122291,8.3,17.9,208559,64958,143601,5.1,16.4,18784,1.5,32.8,0,4262,4264,26919
1982,25,98109,115314,2326030,2298418,15227,13.4,10525,9.3,365422,151423,213999,6.6,15.9,310199,93518,216681,4.1,13.5,55223,2.4,27,0,5952,5958,41362
1982,26,122653,150153,2635256,2686748,20271,13.6,16684,11.2,378525,164822,213703,6.1,14.1,481509,146696,334813,5.5,17.9,-102984,-3.8,28.2,0,9216,9229,56011
1982,27,68675,82180,1436899,1444939,10871,13.3,8521,10.4,229840,95507,134333,6.6,15.9,245919,69598,176321,4.8,17,-16079,-1.1,31.8,0,4805,4815,28031
1982,28,34668,41635,583686,589553,5930,14.3,5009,12.1,88172,41572,46600,7.1,15,99905,33095,66810,5.6,16.9,-11733,-1.9,30,0,2958,2960,14335
1982,29,78834,95510,1656347,1628436,13326,14,11293,11.9,314869,155928,158941,9.6,19.3,259047,86408,172639,5.3,15.9,55822,3.4,31.8,0,6520,6539,37425
1982,30,17061,19631,199487,198996,3067,15.7,2495,12.8,41207,20332,20875,10.2,20.7,40224,13610,26614,6.8,20.2,983,0.5,40.4,0,1431,1434,7960
1982,31,30585,35795,478161,479305,4736,13.3,3882,10.9,77321,34562,42759,7.2,16.1,79609,24952,54657,5.2,16.6,-2288,-0.5,32.2,0,2349,2352,12190
1982,32,15932,18660,338172,334765,3672,20.2,2506,13.8,76892,38356,38536,11.5,23,70078,23514,46564,7,20.9,6814,2.1,41.8,0,1405,1406,10633
1982,33,17902,20303,330170,326448,3051,15.3,2179,10.9,54941,22879,32062,7,16.8,47497,16789,30708,5.1,14.5,7444,2.3,29,0,1280,1281,8359
1982,34,131653,151002,2573073,2548060,20649,13.8,15541,10.4,458679,176477,282202,6.9,18,408653,140547,268106,5.5,16,50026,2,32,0,8816,8825,50152
1982,35,22553,26590,340528,335011,4557,17.5,3230,12.4,72966,33986,38980,10.1,21.8,61932,23084,38848,6.9,18.5,11034,3.3,37,0,1883,1883,11201
1982,36,310167,353434,5972525,5903782,46848,13.4,36885,10.5,1018259,426844,591415,7.2,17.2,880773,296451,584322,5,14.9,137486,2.3,29.8,0,22086,22115,130309
1982,37,88649,109807,1976774,1971868,15544,14.3,11818,10.9,300060,142269,157791,7.2,15.2,290249,91037,199212,4.6,14.7,9811,0.5,29.4,0,7291,7306,39138
1982,38,13511,15672,173855,171440,2196,14.1,1717,11,30690,13504,17186,7.9,17.9,25859,8827,17032,5.1,15.1,4831,2.8,30.2,0,983,984,5189
1982,39,150708,191592,3475089,3505180,24425,12.8,20180,10.6,514307,225594,288713,6.4,14.7,574489,164332,410157,4.7,16.4,-60182,-1.7,29.4,0,10911,10928,65953
1982,40,55973,66080,979254,948317,12115,18.9,7610,11.9,223051,96625,126426,10.2,23.5,161176,57892,103284,6.1,17,61875,6.5,34,0,4620,4622,28924
1982,41,49234,58374,775837,784846,9585,16.4,8939,15.3,152083,74825,77258,9.5,19.4,170100,56123,113977,7.2,21.7,-18017,-2.3,38.8,0,4948,4966,26788
1982,42,170923,209556,3936128,3949692,26138,12.6,20399,9.8,607788,251276,356512,6.4,15.4,634915,185536,449379,4.7,16.1,-27127,-0.7,30.8,0,11478,11509,71664
1982,44,17893,20030,328919,331251,2457,12.3,2060,10.3,46766,20334,26432,6.1,14.1,51429,15245,36184,4.6,15.5,-4663,-1.4,28.2,0,1205,1206,7347
1982,45,43952,53823,925385,922408,8215,15.5,6099,11.5,152053,74256,77797,8.1,16.5,146098,44029,102069,4.8,15.8,5955,0.7,31.6,0,3771,3775,23566
1982,46,13675,15663,167476,167464,1956,12.4,1742,11.1,27787,13301,14486,7.9,16.6,27762,9221,18541,5.5,16.6,25,0,33.2,0,1049,1050,5077
1982,47,66173,81136,1390646,1394260,12311,15.3,9899,12.3,227027,109407,117620,7.8,16.3,234256,71640,162616,5.1,16.8,-7229,-0.5,32.6,0,5816,5823,34057
1982,48,247500,312429,5378890,5202572,58570,19.4,34622,11.5,1258325,585047,673278,11.2,24.2,905689,315744,589945,6.1,17.4,352636,6.8,34.8,0,20273,20290,141174
1982,49,22986,27574,425093,420691,4844,17.9,3521,13,84292,38700,45592,9.2,20,75488,26712,48776,6.3,17.9,8804,2.1,35.8,0,1984,1984,13175
1982,50,11300,12646,162569,162041,1904,15.3,1340,10.8,26015,10831,15184,6.7,16.1,24958,9081,15877,5.6,15.4,1057,0.7,30.8,0,790,803,4287
1982,51,76929,96003,1625986,1613854,14304,15.1,10560,11.1,298575,121685,176890,7.5,18.5,274312,80190,194122,5,17,24263,1.5,34,0,6050,6054,35448
1982,53,73187,87665,1203353,1210645,14846,17.2,10964,12.7,223203,109591,113612,9.1,18.4,237786,72379,165407,6,19.6,-14583,-1.2,36.8,0,6141,6163,34799
1982,54,25331,30387,463146,465341,4213,13.8,3821,12.5,74931,33269,41662,7.1,16.1,79322,28016,51306,6,17,-4391,-0.9,32.2,0,2182,2183,12185
1982,55,78173,92155,1534731,1533972,11979,13.1,9247,10.1,225320,102379,122941,6.7,14.7,223803,65129,158674,4.2,14.6,1517,0.1,29.2,0,5365,5374,28200
1982,56,11394,13083,160792,156388,2497,19.6,1681,13.2,42505,24007,18498,15.4,27.2,33697,10952,22745,7,21.5,8808,5.7,43,0,981,981,5404
1983,1,52544,64532,998744,1008250,7808,12.2,7393,11.5,168720,68834,99886,6.8,16.7,187731,63233,124498,6.3,18.6,-19011,-1.9,33.4,0,4870,4893,28696
1983,2,8803,10382,130578,128817,2258,23.1,1221,12.5,35611,16049,19562,12.5,27.6,32088,10660,21428,8.3,24.9,3523,2.7,49.8,0,757,757,4841
1983,4,46531,57195,833602,822452,9444,16.9,7194,12.9,185411,80318,105093,9.8,22.5,163110,54018,109092,6.6,19.8,22301,2.7,39.6,0,4744,4764,29779
1983,5,35928,41875,572233,570662,5454,13.2,4831,11.7,94642,38017,56625,6.7,16.6,91500,29340,62160,5.1,16,3142,0.6,32,0,3365,3373,16497
1983,6,426525,517992,8179232,8318911,70763,13.8,63498,12.4,1561536,600824,960712,7.2,18.8,1840895,557754,1283141,6.7,22.1,-279359,-3.3,37.6,0,39937,40167,250353
1983,8,62279,73631,1063190,1088826,11843,16.4,9700,13.4,211221,93618,117603,8.6,19.4,262494,72569,189925,6.7,24.1,-51273,-4.7,38.8,0,6414,6443,37788
1983,9,59281,68132,1263298,1261769,7536,11.2,6204,9.2,192179,61781,130398,4.9,15.2,189121,52250,136871,4.1,15,3058,0.2,30,0,4050,4057,21454
1983,10,10287,11930,217119,216652,1429,12.2,1173,10,32779,13150,19629,6.1,15.1,31844,10273,21571,4.7,14.7,935,0.4,29.4,0,711,716,4380
1983,11,14137,16181,361790,347870,2029,12.8,1582,10,77963,19347,58616,5.6,22.4,50123,15442,34681,4.4,14.4,27840,8,28.8,0,964,966,6656
1983,12,190523,230995,3146119,3140133,36830,16.2,32030,14.1,629840,276232,353608,8.8,20.1,617868,233657,384211,7.4,19.7,11972,0.4,39.4,0,19836,19917,117604
1983,13,86220,107503,1769753,1761508,14871,14.1,11586,11,322015,129416,192599,7.3,18.3,305525,100172,205353,5.7,17.3,16490,1,34.6,0,7616,7633,45892
1983,15,17966,21825,310539,312847,2786,13,2259,10.5,53212,21274,31938,6.8,17,57828,17948,39880,5.7,18.5,-4616,-1.5,34,0,1493,1514,9973
1983,16,16847,19903,229903,235178,2616,13.3,2416,12.3,40720,16532,24188,7,17.3,51271,15091,36180,6.4,21.8,-10551,-4.5,34.6,0,1604,1611,8259
1983,17,171922,205093,3717580,3800701,22718,11,25631,12.4,529121,204106,325015,5.4,13.9,695364,229360,466004,6,18.3,-166243,-4.4,27.8,0,14017,14116,86056
1983,18,74720,92678,1614707,1655565,9688,10.2,13103,13.8,219533,74976,144557,4.5,13.3,301250,107237,194013,6.5,18.2,-81717,-4.9,26.6,0,7062,7113,41439
1983,19,53380,63882,800692,832329,6404,10.1,6395,10.1,121119,51705,69414,6.2,14.6,184393,51787,132606,6.2,22.2,-63274,-7.6,29.2,0,4299,4309,21452
1983,20,46397,54753,707161,723605,6689,12.4,5909,10.9,112038,47703,64335,6.6,15.5,144926,49241,95685,6.8,20,-32888,-4.5,31,0,3970,3991,20529
1983,21,51200,61168,905941,925426,7330,12.1,6813,11.2,136880,55408,81472,6,14.8,175850,52537,123313,5.7,19,-38970,-4.2,29.6,0,4617,4627,26753
1983,22,67505,80886,1214215,1260276,10478,13.1,9371,11.7,211612,86133,125479,6.8,16.8,303734,91106,212628,7.2,24.1,-92122,-7.3,33.6,0,6431,6452,46244
1983,23,19679,22814,319017,316509,2679,11.9,2293,10.2,48555,17825,30730,5.6,15.3,43539,15758,27781,5,13.8,5016,1.5,27.6,0,1476,1479,7527
1983,24,63666,76930,1293847,1287477,9553,12.7,7238,9.6,212303,73427,138876,5.7,16.5,199563,65694,133869,5.1,15.5,12740,1,31,0,4651,4678,28240
1983,25,100943,118316,2337014,2332424,12768,10.9,10535,9,346550,123047,223503,5.3,14.9,337370,99432,237938,4.3,14.5,9180,0.4,29,0,6893,6923,46503
1983,26,125644,153060,2612933,2630442,17263,11.4,15659,10.3,368444,132294,236150,5,14,403461,122925,280536,4.7,15.3,-35017,-1.3,28,0,9727,9785,55783
1983,27,70586,84133,1402406,1415725,9308,11.2,8059,9.7,213798,81691,132107,5.8,15.1,240437,71959,168478,5.1,17,-26639,-1.9,30.2,0,5107,5126,31343
1983,28,35579,42480,572756,573951,5128,12.2,4731,11.3,93494,38941,54553,6.8,16.3,95883,30423,65460,5.3,16.7,-2389,-0.4,32.6,0,3268,3285,16561
1983,29,81401,97830,1590662,1615783,11809,12.2,10405,10.8,258888,101736,157152,6.3,16,309130,94026,215104,5.8,19.1,-50242,-3.1,32,0,6689,6731,37841
1983,30,17747,20312,196266,196616,2742,13.7,2316,11.6,38142,17487,20655,8.9,19.4,38842,13221,25621,6.7,19.8,-700,-0.4,38.8,0,1517,1532,8735
1983,31,31522,36679,467988,470635,3935,10.9,3580,9.9,75684,32672,43012,6.9,16.1,80977,26237,54740,5.6,17.2,-5293,-1.1,32.2,0,2302,2312,13286
1983,32,16166,18894,327024,332635,2837,15.1,2680,14.3,57845,26724,31121,8,17.4,69067,21850,47217,6.6,20.8,-11222,-3.4,34.8,0,1785,1790,11404
1983,33,18710,21155,335808,332435,2757,13.3,2047,9.9,56951,20694,36257,6.2,17.1,50204,15980,34224,4.8,15.1,6747,2,30.2,0,1397,1399,8668
1983,34,135784,155152,2608759,2592960,18165,11.9,15165,9.9,446635,157998,288637,6.1,17.2,415036,146772,268264,5.7,16,31599,1.2,32,0,9898,9919,55212
1983,35,23524,27574,333313,334004,4064,15,3329,12.3,68652,31346,37306,9.4,20.6,70034,24772,45262,7.4,21,-1382,-0.4,41.2,0,2171,2174,13363
1983,36,318820,362194,5962654,5967734,41469,11.6,36330,10.2,961456,317971,643485,5.3,16.1,971615,306212,665403,5.1,16.3,-10159,-0.2,32.2,0,25494,25572,144453
1983,37,84954,106253,1942161,1950703,12416,11.5,14735,13.6,292332,116791,175541,6,15,309416,110055,199361,5.6,15.9,-17084,-0.9,30,0,8048,8091,44581
1983,38,13885,16011,169351,171047,1814,11.5,1699,10.7,26955,11272,15683,6.6,15.8,30347,11145,19202,6.5,17.7,-3392,-1.9,31.6,0,1126,1129,6351
1983,39,153316,193622,3377287,3427222,19599,10.2,19332,10,464758,167302,297456,4.9,13.6,564628,153119,411509,4.5,16.5,-99870,-2.9,27.2,0,11704,11785,67935
1983,40,56788,66854,910410,938730,9246,13.9,8785,13.2,167801,73231,94570,7.8,17.9,224440,67328,157112,7.2,23.9,-56639,-6,35.8,0,6382,6404,41020
1983,41,50063,59166,741713,756602,8032,13.7,7702,13.1,132844,53655,79189,7.1,17.6,162621,47491,115130,6.3,21.5,-29777,-3.9,35.2,0,4968,4997,26461
1983,42,175211,213418,3780439,3858417,21694,10.3,20027,9.5,535771,199826,335945,5.2,13.9,691728,190771,500957,4.9,17.9,-155957,-4,27.8,0,12343,12405,73823
1983,44,18294,20366,331844,330492,2117,10.5,1917,9.5,46371,13877,32494,4.2,14,43666,13866,29800,4.2,13.2,2705,0.8,26.4,0,1294,1296,6785
1983,45,42223,52200,896098,906133,6288,11.9,7257,13.7,134088,52909,81179,5.8,14.8,154157,52462,101695,5.8,17,-20069,-2.2,29.6,0,4244,4258,24170
1983,46,14022,15963,165683,166306,1727,10.9,1689,10.7,25336,10567,14769,6.4,15.2,26582,9074,17508,5.5,16,-1246,-0.8,30.4,0,1078,1082,5310
1983,47,67983,82950,1401949,1390465,10662,13,9487,11.6,245309,98496,146813,7.1,17.6,222340,69125,153215,5,16,22969,1.6,32,0,6334,6365,36889
1983,48,256723,322498,5141270,5235903,48412,15.3,40141,12.6,1023994,443744,580250,8.5,19.6,1213260,360208,853052,6.9,23.2,-189266,-3.6,39.2,0,26982,27224,184204
1983,49,23462,28097,418145,420039,3737,13.4,3503,12.6,77531,34332,43199,8.2,18.5,81318,25594,55724,6.1,19.4,-3787,-0.9,37,0,2234,2241,13967
1983,50,11699,13034,161659,162255,1593,12.4,1326,10.3,22357,8713,13644,5.4,13.8,23548,6271,17277,3.9,14.5,-1191,-0.7,27.6,0,903,905,3850
1983,51,80053,99272,1619281,1622123,12236,12.5,9895,10.1,259435,91106,168329,5.6,16,265118,76398,188720,4.7,16.3,-5683,-0.3,32,0,6445,6495,36733
1983,53,76284,90788,1219380,1209917,12747,14.3,10552,11.8,240012,111819,128193,9.2,19.8,221086,67062,154024,5.5,18.3,18926,1.5,36.6,0,6731,6788,36998
1983,54,25732,30755,422090,443302,3370,11,3518,11.5,55257,25259,29998,5.7,12.5,97682,25629,72053,5.8,22,-42425,-9.5,25,0,2316,2320,12624
1983,55,80234,94255,1491567,1514446,9613,10.3,8570,9.2,198020,71810,126210,4.7,13.1,243777,64074,179703,4.2,16.1,-45757,-3,26.2,0,5442,5464,31449
1983,56,11463,13115,134163,146418,1857,14.2,1919,14.7,25288,12811,12477,8.7,17.3,49798,12164,37634,8.3,34,-24510,-16.7,34.6,0,1309,1310,7754
1984,1,55131,67226,1078840,1040566,10047,15.3,7408,11.2,214293,74818,139475,7.2,20.6,137744,56012,81732,5.4,13.2,76549,7.4,26.4,0,4888,4910,28444
1984,2,9725,11370,141117,136072,2460,22.6,1459,13.4,37364,16569,20795,12.2,27.5,27275,10262,17013,7.5,20,10089,7.5,40,0,901,902,5761
1984,4,49969,60952,935167,886020,10974,18.6,7236,12.3,230687,88695,141992,10,26,132393,50377,82016,5.7,14.9,98294,11.1,29.8,0,4630,4652,27226
1984,5,37630,43725,614011,592007,6762,15.8,4943,11.6,119437,42289,77148,7.1,20.2,75429,30775,44654,5.2,12.7,44008,7.5,25.4,0,3360,3379,16933
1984,6,444679,537799,8837527,8502471,81545,15.5,61546,11.7,1942624,684381,1258243,8,22.8,1272513,479088,793425,5.6,15,670111,7.8,30,0,38304,38468,232852
1984,8,65533,77262,1129807,1096554,13264,17.6,9724,12.9,246685,102772,143913,9.4,22.5,180179,67059,113120,6.1,16.4,66506,6.1,32.8,0,6474,6496,35849
1984,9,61318,70361,1324462,1293333,8566,12.4,6343,9.2,224089,74244,149845,5.7,17.3,161830,53883,107947,4.2,12.5,62259,4.8,25,0,4186,4197,24915
1984,10,10604,12269,230731,223684,1638,13.5,1301,10.8,40626,13842,26784,6.2,18.2,26531,9630,16901,4.3,11.9,14095,6.3,23.8,0,780,783,3760
1984,11,13795,15915,347156,353915,1872,11.7,2076,12.9,56082,19397,36685,5.5,15.8,69599,18146,51453,5.1,19.7,-13517,-3.9,31.6,0,1174,1174,6856
1984,12,205001,247104,3496460,3323078,44794,18.7,28688,12,840162,357042,483120,10.7,25.3,493400,197000,296400,5.9,14.8,346762,10.5,29.6,0,19565,19670,108461
1984,13,90948,112861,1932962,1851517,17162,15.6,11958,10.9,389588,141533,248055,7.6,21,226698,91217,135481,4.9,12.2,162890,8.8,24.4,0,7528,7557,45176
1984,15,17956,21814,310374,310392,2526,11.6,2524,11.6,49089,18030,31059,5.8,15.8,49124,17518,31606,5.6,15.8,-35,0,31.6,0,1550,1582,8837
1984,16,17352,20478,247744,238912,2860,14.2,2291,11.3,52032,17799,34233,7.5,21.8,34367,13600,20767,5.7,14.4,17665,7.4,28.8,0,1562,1565,8122
1984,17,180759,214653,3975039,3852501,27765,13.2,19477,9.3,709371,237105,472266,6.2,18.4,464295,164694,299601,4.3,12.1,245076,6.3,24.2,0,10290,10342,52953
1984,18,82027,100394,1747070,1684601,12190,12.6,6393,6.6,316494,110539,205955,6.6,18.8,191557,67612,123945,4,11.4,124937,7.4,22.8,0,154,177,1833
1984,19,54229,64899,826091,813011,7692,11.9,6649,10.3,136534,51458,85076,6.3,16.8,110374,37661,72713,4.6,13.6,26160,3.2,27.2,0,4428,4440,20054
1984,20,46998,55561,776666,742248,7846,14.2,7106,12.9,173451,53651,119800,7.2,23.4,104615,45504,59111,6.1,14.1,68836,9.3,28.2,0,4155,4165,22608
1984,21,52671,62817,949624,928305,8711,14.1,7020,11.3,165359,61986,103373,6.7,17.8,122720,48459,74261,5.2,13.2,42639,4.6,26.4,0,4725,4734,27193
1984,22,68749,82546,1235284,1226190,11545,14.1,9921,12.1,230392,89989,140403,7.3,18.8,212203,74050,138153,6,17.3,18189,1.5,34.6,0,6603,6629,36860
1984,23,20626,23855,337428,327843,3322,14.3,2229,9.6,56500,19395,37105,5.9,17.2,37332,13132,24200,4,11.4,19168,5.8,22.8,0,1444,1452,6650
1984,24,63711,77389,1381406,1335480,9645,12.5,9054,11.7,262845,99212,163633,7.4,19.7,170993,70808,100185,5.3,12.8,91852,6.9,25.6,0,5196,5215,30947
1984,25,104728,122586,2510851,2429731,14765,12.3,10659,8.9,441267,137305,303962,5.7,18.2,279027,92180,186847,3.8,11.5,162240,6.7,23,0,6883,6898,41653
1984,26,130961,158622,2789503,2681906,20580,13.2,15341,9.8,513144,158635,354509,5.9,19.1,297949,126633,171316,4.7,11.1,215195,8,22.2,0,9657,9713,51279
1984,27,73460,87221,1510612,1456920,11474,13.4,8466,9.9,286969,98677,188292,6.8,19.7,179586,70120,109466,4.8,12.3,107383,7.4,24.6,0,5380,5429,32224
1984,28,36901,43905,613586,592836,6229,14.4,4866,11.3,115408,41445,73963,7,19.5,73908,30132,43776,5.1,12.5,41500,7,25,0,3259,3270,14956
1984,29,83049,99804,1697664,1653195,13240,13.4,11509,11.6,311611,110754,200857,6.7,18.8,222672,82722,139950,5,13.5,88939,5.3,27,0,7253,7282,42206
1984,30,18556,21150,201683,199000,3208,15.5,2377,11.5,38149,15311,22838,7.7,19.2,32782,11651,21131,5.9,16.5,5367,2.7,33,0,1552,1555,6989
1984,31,31290,36549,478633,476580,4229,11.6,4367,11.9,77222,29415,47807,6.2,16.2,73116,27304,45812,5.7,15.3,4106,0.9,30.6,0,2538,2550,12842
1984,32,17175,20008,362038,344379,3534,18.2,2414,12.4,83030,28627,54403,8.3,24.1,47712,20053,27659,5.8,13.9,35318,10.2,27.8,0,1581,1581,9125
1984,33,19936,22502,371073,350282,3478,15.9,2150,9.9,80691,30233,50458,8.6,23,39109,16513,22596,4.7,11.2,41582,11.8,22.4,0,1426,1431,7893
1984,34,139850,159787,2757643,2680759,20005,12.7,15532,9.9,510410,179532,330878,6.7,19,356643,125499,231144,4.7,13.3,153767,5.7,26.6,0,10005,10027,54111
1984,35,24337,28428,353209,344054,4467,16,3567,12.7,76638,32936,43702,9.6,22.3,58327,21031,37296,6.1,17,18311,5.3,34,0,2361,2366,12325
1984,36,325032,368864,6208090,6098043,44919,12.3,38378,10.5,1057745,369700,688045,6.1,17.3,837651,286826,550825,4.7,13.7,220094,3.6,27.4,0,26258,26303,161914
1984,37,97440,119459,2133542,2036696,17572,15.6,6617,5.9,387042,126593,260449,6.2,19,193351,55610,137741,2.7,9.5,193691,9.5,19,0,229,238,1748
1984,38,14097,16297,173954,171788,2070,12.8,1820,11.3,29812,12489,17323,7.3,17.4,25479,9907,15572,5.8,14.8,4333,2.6,29.6,0,1054,1057,5056
1984,39,158037,198451,3566633,3473025,23383,11.9,18802,9.6,594153,193115,401038,5.6,17.1,406936,135380,271556,3.9,11.7,187217,5.4,23.4,0,11408,11500,57091
1984,40,58096,68465,916210,914377,10459,15.5,8768,13,172943,73347,99596,8,18.9,169276,61369,107907,6.7,18.5,3667,0.4,37,0,6210,6219,33190
1984,41,52488,61764,789770,765617,9605,15.9,7056,11.7,159912,57324,102588,7.5,20.9,111605,40900,70705,5.3,14.6,48307,6.3,29.2,0,4723,4734,22444
1984,42,178897,217550,3956921,3867817,25270,11.7,21228,9.9,661881,221398,440483,5.7,17.1,483673,175689,307984,4.5,12.5,178208,4.6,25,0,12917,12986,76271
1984,44,18807,20880,352474,342634,2513,12.2,1979,9.6,59505,19188,40317,5.6,17.4,39825,13618,26207,4,11.6,19680,5.8,23.2,0,1323,1327,6390
1984,45,47769,58107,978827,939435,8628,15.6,3833,7,179374,68179,111195,7.3,19.1,100590,33215,67375,3.5,10.7,78784,8.4,21.4,0,127,130,1221
1984,46,14265,16255,175073,170373,2152,13.4,1868,11.6,31902,11634,20268,6.8,18.7,22501,9678,12823,5.7,13.2,9401,5.5,26.4,0,1067,1069,4851
1984,47,71056,86268,1490223,1448092,13075,15.5,9748,11.5,281450,102898,178552,7.1,19.4,197188,72803,124385,5,13.6,84262,5.8,27.2,0,6436,6470,35131
1984,48,264087,331836,5388102,5266929,52193,16,42669,13,1168089,500908,667181,9.5,22.2,925744,339773,585971,6.5,17.6,242345,4.6,35.2,0,27903,28027,172173
1984,49,24394,29145,449254,433754,4422,15.5,3373,11.8,91978,33889,58089,7.8,21.2,60977,23668,37309,5.5,14.1,31001,7.1,28.2,0,2145,2146,12195
1984,50,12307,13692,173431,167245,2009,15,1326,9.9,30713,11647,19066,7,18.4,18340,7393,10947,4.4,11,12373,7.4,22,0,899,901,4290
1984,51,78710,98404,1701415,1653109,13550,13.7,13611,13.8,313382,109223,204159,6.6,19,216769,97964,118805,5.9,13.1,96613,5.9,26.2,0,7053,7076,41783
1984,53,80699,95496,1287333,1252183,15155,16.3,10507,11.3,263631,100133,163498,8,21.1,193330,67857,125473,5.4,15.4,70301,5.7,30.8,0,6911,6919,35792
1984,54,24686,29711,424486,421855,3703,12.2,4501,14.9,69714,25796,43918,6.1,16.5,64451,29789,34662,7.1,15.3,5263,1.2,30.6,0,2264,2269,11559
1984,55,82663,96976,1585837,1538757,11910,12.5,9209,9.6,272147,89245,182902,5.8,17.7,177987,64394,113593,4.2,11.6,94160,6.1,23.2,0,5804,5824,28489
1984,56,11516,13191,134578,134582,1917,14.6,1834,13.9,28212,13698,14514,10.2,21,28220,10505,17715,7.8,21,-8,0,42,0,1145,1148,5522
1985,1,56912,69281,1132346,1113433,9643,14.1,7851,11.5,199547,71033,128514,6.4,17.9,161721,62358,99363,5.6,14.5,37826,3.4,29,0,5163,5194,32527
1985,2,10190,11921,153563,149485,2344,20.1,1806,15.5,40778,16613,24165,11.1,27.3,32622,14201,18421,9.5,21.8,8156,5.5,43.6,0,1176,1182,6119
1985,4,53301,64627,1050209,998162,11658,18.6,7967,12.7,263428,99263,164165,9.9,26.4,159336,69517,89819,7,16,104092,10.4,32,0,5211,5243,37097
1985,5,38833,44972,657370,650357,6144,13.8,5293,11.9,112379,40981,71398,6.3,17.3,98355,42085,56270,6.5,15.1,14024,2.2,30.2,0,3689,3723,21198
1985,6,463335,556727,9259538,9082497,83678,15.3,65037,11.9,1922736,709582,1213154,7.8,21.2,1568656,619622,949034,6.8,17.3,354080,3.9,34.6,0,39800,40061,282691
1985,8,67395,79431,1162001,1146721,13227,16.9,11083,14.1,235665,98226,137439,8.6,20.6,205105,85818,119287,7.5,17.9,30560,2.7,35.8,0,7465,7490,48099
1985,9,63246,72522,1386817,1362196,9032,12.6,6971,9.7,220573,66241,154332,4.9,16.2,171331,65111,106220,4.8,12.6,49242,3.6,25.2,0,4634,4646,29480
1985,10,11017,12723,245353,239372,1736,13.9,1276,10.2,42830,13394,29436,5.6,17.9,30869,11164,19705,4.7,12.9,11961,5,25.8,0,767,769,4618
1985,11,14294,16494,363935,355698,1976,12.2,1466,9,66344,23856,42488,6.7,18.7,49869,21144,28725,5.9,14,16475,4.7,28,0,423,434,6255
1985,12,215183,259355,3696047,3603154,44963,17.8,32411,12.8,815058,337217,477841,9.4,22.6,629271,254032,375239,7.1,17.5,185787,5.1,35,0,22038,22121,140166
1985,13,96292,118772,2098049,2028417,18300,15.8,12563,10.8,418773,150046,268727,7.4,20.6,279509,109586,169923,5.4,13.8,139264,6.8,27.6,0,7870,7918,48982
1985,15,18461,22380,320736,315645,2932,13.3,2314,10.5,55452,22103,33349,7,17.6,45270,17155,28115,5.4,14.3,10182,3.3,28.6,0,1465,1477,7716
1985,16,17723,20891,250384,250870,2775,13.4,2476,11.9,43953,16276,27677,6.5,17.5,44927,15255,29672,6.1,17.9,-974,-0.4,35,0,1631,1640,9033
1985,17,184687,218925,4098265,4067478,26121,12,23140,10.6,655700,237210,418490,5.8,16.1,594125,221094,373031,5.4,14.6,61575,1.5,29.2,0,14721,14802,98253
1985,18,84522,102985,1818091,1798123,12819,12.6,10773,10.6,282753,108971,173782,6.1,15.7,242816,90554,152262,5,13.5,39937,2.2,27,0,6797,6829,43440
1985,19,53775,64348,851267,848530,6648,10.3,7414,11.4,124501,44205,80296,5.2,14.7,119027,48584,70443,5.7,14,5474,0.7,28,0,4929,4948,25396
1985,20,48791,57359,789362,791333,7929,14,6263,11.1,136568,55726,80842,7,17.3,140509,70258,70251,8.9,17.8,-3941,-0.5,34.6,0,4115,4133,25697
1985,21,54179,64329,1041138,1021005,8041,12.6,7045,11,170319,60940,109379,6,16.7,130053,53063,76990,5.2,12.7,40266,4,25.4,0,4785,4813,26364
1985,22,69544,83458,1246613,1245481,11190,13.5,10258,12.3,223562,88969,134593,7.1,17.9,221297,81863,139434,6.6,17.8,2265,0.1,35.6,0,6826,6863,41087
1985,23,21798,25029,347854,344939,3484,14.2,2478,10.1,57908,22502,35406,6.5,16.8,52078,22716,29362,6.6,15.1,5830,1.7,30.2,0,1569,1573,9300
1985,24,68499,82647,1483592,1433200,11590,14.5,6614,8.3,297022,108153,188869,7.5,20.7,196237,70844,125393,4.9,13.7,100785,7,27.4,0,2357,2388,22247
1985,25,108639,126971,2607273,2560822,15969,12.8,11616,9.3,440902,134453,306449,5.3,17.2,347999,129341,218658,5.1,13.6,92903,3.6,27.2,0,7528,7557,60988
1985,26,135234,163374,2917295,2852965,20922,13,16244,10.1,522402,204646,317756,7.2,18.3,393742,172626,221116,6.1,13.8,128660,4.5,27.6,0,10579,10637,64329
1985,27,75214,89183,1585787,1558545,11268,12.7,9546,10.8,276891,105659,171232,6.8,17.8,222407,96877,125530,6.2,14.3,54484,3.5,28.6,0,6200,6232,53936
1985,28,37582,44776,658434,652392,5868,13.2,5149,11.6,107830,40229,67601,6.2,16.5,95745,37077,58668,5.7,14.7,12085,1.8,29.4,0,3458,3475,18718
1985,29,86035,103025,1766856,1746099,13844,13.6,11051,10.9,290666,110311,180355,6.3,16.6,249152,109080,140072,6.2,14.3,41514,2.3,28.6,0,7277,7311,45467
1985,30,19075,21611,217851,218706,2937,13.6,2749,12.8,35559,14044,21515,6.4,16.3,37270,16142,21128,7.4,17,-1711,-0.7,32.6,0,1818,1821,8406
1985,31,32819,38075,511015,503949,4732,12.6,3900,10.4,84172,36372,47800,7.2,16.7,70040,31540,38500,6.3,13.9,14132,2.8,27.8,0,2604,2615,16633
1985,32,17610,20477,376694,369635,3348,16.5,2866,14.2,72343,28136,44207,7.6,19.6,58224,28182,30042,7.6,15.8,14119,3.8,31.6,0,1893,1898,13382
1985,33,21583,24267,411384,400577,3924,16.7,2409,10.3,78727,27577,51150,6.9,19.7,57113,23024,34089,5.7,14.3,21614,5.4,28.6,0,1595,1598,11106
1985,34,145133,165713,2906293,2849387,21812,13.4,16271,10,525815,172759,353056,6.1,18.5,412003,154698,257305,5.4,14.5,113812,4,29,0,10731,10773,67952
1985,35,24957,29064,380560,373603,4371,15.2,3717,12.9,78884,29959,48925,8,21.1,64970,29429,35541,7.9,17.4,13914,3.7,34.8,0,2389,2398,14299
1985,36,333449,378082,6409470,6319570,47729,12.8,39206,10.5,1042780,343528,699252,5.4,16.5,862981,333932,529049,5.3,13.7,179799,2.8,27.4,0,27164,27269,161630
1985,37,102154,124692,2245934,2207320,17433,14.3,12483,10.2,366832,132515,234317,6,16.6,289604,101049,188555,4.6,13.1,77228,3.5,26.2,0,7986,8015,45862
1985,38,14665,16856,189842,187786,2061,12.3,1780,10.6,29804,11645,18159,6.2,15.9,25691,9754,15937,5.2,13.7,4113,2.2,27.4,0,1146,1148,5578
1985,39,161197,201409,3679569,3613399,23163,11.6,20020,10,597659,176775,420884,4.9,16.5,465318,192231,273087,5.3,12.9,132341,3.6,25.8,0,12396,12498,85941
1985,40,58657,69175,954877,956032,9763,14.1,9458,13.7,160388,65874,94514,6.9,16.8,162698,63118,99580,6.6,17,-2310,-0.2,33.6,0,6610,6627,35441
1985,41,53731,62937,833804,822734,9131,14.6,8226,13.2,157891,60376,97515,7.3,19.2,135751,56836,78915,6.9,16.5,22140,2.7,33,0,5457,5497,30668
1985,42,182763,221551,4019312,3993535,26054,11.9,22207,10.1,616234,218257,397977,5.5,15.4,564679,230076,334603,5.8,14.1,51555,1.3,28.2,0,13634,13738,114523
1985,44,19380,21510,360175,356520,2694,12.7,2099,9.9,54859,17353,37506,4.9,15.4,47548,16914,30634,4.7,13.3,7311,2.1,26.6,0,1436,1437,10390
1985,45,50227,60929,1032254,1013079,8859,14.9,6276,10.5,183068,68447,114621,6.8,18.1,144718,52857,91861,5.2,14.3,38350,3.8,28.6,0,4133,4146,26797
1985,46,14857,16860,192722,189567,2187,13.1,1736,10.4,31896,14139,17757,7.5,16.8,25585,9286,16299,4.9,13.5,6311,3.3,27,0,1103,1109,5389
1985,47,73571,89122,1571160,1541928,12383,14.1,9898,11.3,266622,96286,170336,6.2,17.3,208158,81604,126554,5.3,13.5,58464,3.8,27,0,6494,6543,36655
1985,48,273913,343094,5567596,5483001,53243,15.8,41802,12.4,1143113,473639,669474,8.6,20.8,973924,372125,601799,6.8,17.8,169189,3,35.6,0,26855,27032,180585
1985,49,24876,29631,469167,459954,4416,15,3945,13.4,88022,32576,55446,7.1,19.1,69596,27789,41807,6,15.1,18426,4,30.2,0,2573,2584,16161
1985,50,13197,14589,188844,186294,2111,14.8,1466,10.3,29856,10825,19031,5.8,16,24755,10746,14009,5.8,13.3,5101,2.7,26.6,0,973,974,4555
1985,51,88338,108831,1848069,1794199,15573,15,6355,6.1,331325,128740,202585,7.2,18.5,223586,71606,151980,4,12.5,107739,6,25,0,297,341,7896
1985,53,82897,97860,1351235,1331096,14338,14.8,12182,12.6,257231,99935,157296,7.5,19.3,216953,84947,132006,6.4,16.3,40278,3,32.6,0,7835,7887,45016
1985,54,26919,31943,444457,440038,3889,12.6,2239,7.2,66558,29429,37129,6.7,15.1,57720,16872,40848,3.8,13.1,8838,2,26.2,0,133,140,1302
1985,55,84423,98750,1608984,1594054,11542,11.8,9535,9.7,234681,80771,153910,5.1,14.7,204822,82303,122519,5.2,12.8,29859,1.9,25.6,0,6419,6470,40601
1985,56,11613,13266,136254,136375,1862,14,1811,13.7,26139,10897,15242,8,19.2,26380,10685,15695,7.8,19.3,-241,-0.1,38.4,0,1172,1174,6200
1986,1,58632,71453,1184376,1157381,10401,14.8,7920,11.3,225622,85608,140014,7.4,19.5,171632,61203,110429,5.3,14.8,53990,4.7,29.6,0,5302,5326,33580
1986,2,10334,12059,147858,150145,2279,19,2058,17.2,34020,15501,18519,10.3,22.7,38593,14048,24545,9.4,25.7,-4573,-3,45.4,0,1314,1314,7233
1986,4,56021,68009,1105166,1077174,12290,18.5,8629,13,260749,115197,145552,10.7,24.2,204766,75326,129440,7,19,55983,5.2,38,0,5788,5795,41667
1986,5,39349,45522,687515,671920,6169,13.6,5405,11.9,130659,50533,80126,7.5,19.4,99469,37861,61608,5.6,14.8,31190,4.6,29.6,0,3776,3794,20445
1986,6,481367,578245,9605927,9425622,92039,16.2,68246,12,2021721,831186,1190535,8.8,21.4,1661111,610087,1051024,6.5,17.6,360610,3.8,35.2,0,42805,42911,299067
1986,8,68446,80953,1185511,1173042,13367,16.7,11490,14.3,251242,114883,136359,9.8,21.4,226304,93801,132503,8,19.3,24938,2.1,38.6,0,7644,7664,51906
1986,9,65661,75146,1424574,1405305,9970,13.5,7109,9.6,226810,91051,135759,6.5,16.1,188271,64080,124191,4.6,13.4,38539,2.7,26.8,0,4640,4646,34398
1986,10,11623,13416,270616,257352,2022,15.5,1290,9.9,63684,34469,29215,13.4,24.7,37155,12350,24805,4.8,14.4,26529,10.3,28.8,0,793,794,4447
1986,11,14631,16941,386714,382327,2141,12.8,1645,9.8,65330,27220,38110,7.1,17.1,56555,17665,38890,4.6,14.8,8775,2.3,29.6,0,981,984,7296
1986,12,225849,271895,3882883,3787064,47639,17.9,34112,12.8,865423,379409,486014,10,22.9,673785,259595,414190,6.9,17.8,191638,5.1,35.6,0,23279,23315,147181
1986,13,100753,124195,2207873,2152644,19703,16.2,13764,11.3,432317,170526,261791,7.9,20.1,321858,126086,195772,5.9,15,110459,5.1,30,0,8760,8766,56265
1986,15,18962,23021,341427,330967,3031,13.4,2310,10.2,66728,26418,40310,8,20.2,45808,15988,29820,4.8,13.8,20920,6.4,27.6,0,1500,1500,7798
1986,16,18045,21214,255409,252676,2850,13.5,2419,11.5,45529,17461,28068,6.9,18,40064,13425,26639,5.3,15.9,5465,2.1,31.8,0,1555,1560,8338
1986,17,188822,223804,4210612,4150945,27716,12.5,22199,10,700200,271128,429072,6.5,16.9,580865,211947,368918,5.1,14,119335,2.9,28,0,14132,14170,98907
1986,18,86858,105738,1877135,1844746,13514,13,10403,10,305946,123287,182659,6.7,16.6,241167,85681,155486,4.6,13.1,64779,3.5,26.2,0,6855,6886,45431
1986,19,53506,64001,865445,857042,6850,10.7,6959,10.8,138125,55884,82241,6.5,16.1,121318,44779,76539,5.2,14.2,16807,1.9,28.4,0,4628,4628,24201
1986,20,48864,57538,804206,796088,7306,12.7,6866,12,139924,58771,81153,7.4,17.6,123687,48094,75593,6,15.5,16237,2.1,31,0,4727,4753,24706
1986,21,55342,65772,1081414,1060227,8501,13.1,6834,10.5,181240,71996,109244,6.8,17.1,138865,49418,89447,4.7,13.1,42375,4,26.2,0,4718,4732,27904
1986,22,69074,83254,1222471,1233466,11064,13.3,10891,13.1,221946,96890,125056,7.9,18,243935,83578,160357,6.8,19.8,-21989,-1.8,36,0,7529,7543,45765
1986,23,23023,26316,364765,356357,4022,15.7,2640,10.3,65220,25335,39885,7.1,18.3,48404,19196,29208,5.4,13.6,16816,4.7,27.2,0,1709,1726,9632
1986,24,72476,87163,1566107,1523428,13097,15.4,8405,9.9,317011,128363,188648,8.4,20.8,231652,83773,147879,5.5,15.2,85359,5.6,30.4,0,5197,5320,38822
1986,25,112759,131639,2677182,2639593,17753,13.7,12640,9.8,475997,181936,294061,6.9,18,400819,142375,258444,5.4,15.2,75178,2.8,30.4,0,8087,8110,67530
1986,26,138457,167457,3089466,3002942,21758,13.2,17200,10.4,549953,202936,347017,6.8,18.3,376905,140315,236590,4.7,12.6,173048,5.7,25.2,0,11282,11304,71744
1986,27,76442,90673,1621199,1602362,11598,12.9,9799,10.9,283582,102928,180654,6.4,17.7,245908,91580,154328,5.7,15.3,37674,2.4,30.6,0,6195,6222,47655
1986,28,38321,45637,686801,672219,6082,13.5,4998,11.1,129274,46184,83090,6.9,19.2,100110,36659,63451,5.5,14.9,29164,4.3,29.8,0,3274,3287,19813
1986,29,89481,107039,1835557,1800023,14590,13.9,10328,9.8,328693,131974,196719,7.3,18.3,257625,93554,164071,5.2,14.3,71068,4,28.6,0,6065,6105,42376
1986,30,19049,21616,215539,216724,2963,13.7,2819,13,35605,15324,20281,7.1,16.4,37975,14728,23247,6.8,17.5,-2370,-1.1,32.8,0,1920,1922,9412
1986,31,32831,38081,518013,514366,4134,10.9,3983,10.5,81274,35553,45721,6.9,15.8,73979,25011,48968,4.9,14.4,7295,1.4,28.8,0,2580,2587,13586
1986,32,18215,21156,394610,385332,3655,17.6,2892,13.9,81519,34820,46699,9,21.2,62964,28572,34392,7.4,16.3,18555,4.9,32.6,0,1917,1918,14199
1986,33,23372,26274,433618,422463,4738,18.8,2648,10.5,88346,38453,49893,9.1,20.9,66036,28202,37834,6.7,15.6,22310,5.3,31.2,0,1790,1792,12060
1986,34,150350,171226,2986202,2944392,23665,14.1,17620,10.5,553633,214175,339458,7.3,18.8,470013,160387,309626,5.4,16,83620,2.8,32,0,11489,11516,70144
1986,35,25596,29892,386995,383371,4739,16.1,3716,12.6,77333,35846,41487,9.4,20.2,70084,23233,46851,6.1,18.3,7249,1.9,36.6,0,2403,2406,13860
1986,36,340665,385847,6593894,6500576,50318,13.2,41452,10.9,1129566,414808,714758,6.4,17.4,942930,342622,600308,5.3,14.5,186636,2.9,29,0,28328,28410,162758
1986,37,106575,129912,2356148,2299501,18746,14.7,12980,10.2,419590,171526,248064,7.5,18.2,306297,108597,197700,4.7,13.3,113293,4.9,26.6,0,8483,8575,53050
1986,38,14663,16877,188783,189321,1872,11.1,1772,10.5,27525,11098,16427,5.9,14.5,28600,9665,18935,5.1,15.1,-1075,-0.6,29,0,1166,1169,5941
1986,39,164803,205790,3773435,3724438,24889,12.2,19916,9.8,615519,231041,384478,6.2,16.5,517525,192799,324726,5.2,13.9,97994,2.6,27.8,0,12614,12652,108634
1986,40,57573,68273,935450,944583,9336,13.6,9842,14.3,162161,72705,89456,7.7,17.2,180426,68349,112077,7.2,19.1,-18265,-1.9,34.4,0,6903,6921,37329
1986,41,55461,64788,856481,844265,9833,15.4,7795,12.2,159209,65899,93310,7.8,18.9,134776,53627,81149,6.4,16,24433,2.9,32,0,5225,5230,30161
1986,42,189297,228727,4139653,4077993,29133,12.9,21222,9.4,689569,276819,412750,6.8,16.9,566251,196938,369313,4.8,13.9,123318,3,27.8,0,13428,13461,99309
1986,44,20131,22351,379889,369719,3072,14,2141,9.8,64942,24614,40328,6.7,17.6,44602,17355,27247,4.7,12.1,20340,5.5,24.2,0,1435,1439,10578
1986,45,52170,63182,1059212,1044982,9136,14.7,6574,10.6,189989,76186,113803,7.3,18.2,161529,59133,102396,5.7,15.5,28460,2.7,31,0,4250,4253,26641
1986,46,14947,16960,193179,192990,1936,11.5,1766,10.4,29745,12404,17341,6.4,15.4,29367,10640,18727,5.5,15.2,378,0.2,30.4,0,1115,1116,6723
1986,47,75785,91801,1637918,1603162,13073,14.5,10016,11.1,299494,116341,183153,7.3,18.7,229983,87653,142330,5.5,14.3,69511,4.4,28.6,0,6690,6703,47135
1986,48,277737,348251,5562042,5560391,52915,15.3,46152,13.4,1092133,473543,618590,8.5,19.6,1088830,400360,688470,7.2,19.6,3303,0,39.2,0,31057,31200,211729
1986,49,25259,30152,487606,481145,4576,15.3,3936,13.2,98066,43697,54369,9.1,20.4,85146,31298,53848,6.5,17.7,12920,2.7,35.4,0,2551,2560,17844
1986,50,13768,15239,199878,194253,2338,15.7,1623,10.9,35106,13666,21440,7,18.1,23855,9353,14502,4.8,12.3,11251,5.8,24.6,0,1120,1120,5725
1986,51,93023,114591,1985941,1915710,17141,15.4,11112,10,387682,158528,229154,8.3,20.2,247220,89320,157900,4.7,12.9,140462,7.3,25.8,0,7064,7079,42481
1986,53,85618,100884,1409129,1379614,15697,15.8,12163,12.2,289815,111578,178237,8.1,21,230784,89732,141052,6.5,16.7,59031,4.3,33.4,0,7811,7853,47218
1986,54,27212,32206,448403,446450,3993,12.5,3655,11.4,79096,36995,42101,8.3,17.7,75190,33297,41893,7.5,16.8,3906,0.9,33.6,0,2302,2308,12429
1986,55,80619,95074,1602735,1599712,10433,10.8,12889,13.3,245305,92212,153093,5.8,15.3,239258,110294,128964,6.9,15,6047,0.3,30,0,6909,6944,41795
1986,56,11371,13026,132372,133836,1674,12.7,1843,14,25062,11042,14020,8.3,18.7,27990,10450,17540,7.8,20.9,-2928,-2.2,37.4,0,1240,1241,6542
1987,1,60258,73814,1207912,1199933,11289,15.5,8628,11.9,216386,85657,130729,7.1,18,200427,71223,129204,5.9,16.7,15959,1.3,33.4,0,5560,5603,33713
1987,2,9909,11684,139954,145081,2008,16.9,2282,19.2,28996,12877,16119,8.9,20,39249,16191,23058,11.2,27.1,-10253,-7.1,40,0,1453,1467,9133
1987,4,58312,71496,1133544,1124217,13527,19.4,9666,13.8,245492,115371,130121,10.3,21.8,226839,97434,129405,8.7,20.2,18653,1.6,40.4,0,6185,6243,45711
1987,5,39895,46466,702697,699489,6841,14.9,5662,12.3,120295,46686,73609,6.7,17.2,113879,46660,67219,6.7,16.3,6416,0.9,32.6,0,3946,3977,26184
1987,6,498635,601789,10025009,9876925,101089,17.1,74314,12.6,2140050,844917,1295133,8.6,21.7,1843882,774323,1069559,7.8,18.7,296168,3,37.4,0,47029,47583,364518
1987,8,68770,81907,1157028,1178023,13883,17,12492,15.3,229637,110439,119198,9.4,19.5,271628,117338,154290,10,23.1,-41991,-3.6,39,0,7989,8089,57758
1987,9,68352,78648,1489629,1460148,11755,15.3,7988,10.4,252783,91548,161235,6.3,17.3,193820,73979,119841,5.1,13.3,58963,4,26.6,0,5283,5306,36699
1987,10,12149,14142,270756,272430,2242,16.3,1477,10.7,52054,16597,35457,6.1,19.1,55401,14697,40704,5.4,20.3,-3347,-1.2,38.2,0,928,930,5413
1987,11,14834,17226,409098,400175,2199,12.9,1898,11.1,70148,24323,45825,6.1,17.5,52301,20411,31890,5.1,13.1,17847,4.4,26.2,0,1065,1075,8840
1987,12,235605,286064,4052694,3985010,53009,19,37424,13.4,896537,415465,481072,10.4,22.5,761169,320784,440385,8,19.1,135368,3.4,38.2,0,25802,25992,175357
1987,13,104235,129760,2298275,2264157,21406,16.8,15350,12.1,459767,202575,257192,8.9,20.3,391530,151036,240494,6.7,17.3,68237,3,34.6,0,9723,9797,67546
1987,15,19498,23813,361743,353211,3507,15,2595,11.1,76358,30007,46351,8.5,21.6,59295,24875,34420,7,16.8,17063,4.8,33.6,0,1622,1633,10993
1987,16,18373,21599,253893,254537,3178,14.8,2638,12.3,47854,20791,27063,8.2,18.8,49141,20079,29062,7.9,19.3,-1287,-0.5,37.6,0,1537,1550,10530
1987,17,192019,228978,4229224,4231432,30900,13.6,24875,11,687153,265174,421979,6.3,16.2,691568,274392,417176,6.5,16.3,-4415,-0.1,32.4,0,15382,15488,104955
1987,18,88833,108810,1960478,1924600,14910,13.9,11525,10.7,353337,126671,226666,6.6,18.4,281583,113286,168297,5.9,14.6,71754,3.8,29.2,0,7323,7373,50516
1987,19,53485,64358,885893,879800,7777,12.1,7171,11.2,143599,57948,85651,6.6,16.3,131415,51174,80241,5.8,14.9,12184,1.4,29.8,0,4489,4542,24994
1987,20,48902,57880,785412,798076,7721,13.4,7134,12.4,135912,59650,76262,7.5,17,161239,83055,78184,10.4,20.2,-25327,-3.2,34,0,4640,4692,27895
1987,21,56371,67315,1115576,1103241,9387,14.1,7617,11.4,186371,71749,114622,6.5,16.9,161701,66003,95698,6,14.7,24670,2.2,29.4,0,4843,4856,30051
1987,22,66413,80657,1160033,1194069,10618,12.9,12638,15.4,204622,90747,113875,7.6,17.1,272694,108818,163876,9.1,22.8,-68072,-5.7,34.2,0,8115,8198,52695
1987,23,24466,28132,392211,380077,4819,17.7,2921,10.7,75615,31643,43972,8.3,19.9,51346,22516,28830,5.9,13.5,24269,6.4,27,0,1913,1919,10741
1987,24,75600,91738,1670865,1625958,14447,16.1,9700,10.8,348944,158823,190121,9.8,21.5,259129,97294,161835,6,15.9,89815,5.6,31.8,0,6109,6174,44486
1987,25,116843,137044,2733686,2714202,19822,14.7,13906,10.3,473911,176743,297168,6.5,17.5,434943,160365,274578,5.9,16,38968,1.5,32,0,9122,9171,71481
1987,26,142590,173541,3176683,3145898,24912,14.6,18162,10.6,535759,205052,330707,6.5,17,474188,170193,303995,5.4,15.1,61571,1.9,30.2,0,11693,11790,76813
1987,27,77712,92833,1666914,1652471,12682,13.8,10129,11,288814,109734,179080,6.6,17.5,259929,112907,147022,6.8,15.7,28885,1.8,31.4,0,6289,6337,62687
1987,28,38748,46337,690803,692283,6546,14.2,5565,12.1,117603,47945,69658,6.9,17,120562,43041,77521,6.2,17.4,-2959,-0.4,34,0,3713,3747,23135
1987,29,91760,110631,1892232,1870391,16492,15.1,12585,11.6,344750,138117,206633,7.4,18.4,301068,119821,181247,6.4,16.1,43682,2.3,32.2,0,8071,8146,54171
1987,30,19004,21722,219048,217967,3181,14.7,2930,13.5,41299,17391,23908,8,18.9,39136,15770,23366,7.2,18,2163,0.9,36,0,1878,1894,8811
1987,31,33068,38627,531725,527146,4636,12.1,3924,10.2,87190,32309,54881,6.1,16.5,78032,33039,44993,6.3,14.8,9158,1.7,29.6,0,2525,2553,14759
1987,32,19134,22308,433876,415755,4225,19.4,2972,13.7,102575,42001,60574,10.1,24.7,66333,26724,39609,6.4,16,36242,8.7,32,0,1874,1894,14762
1987,33,25250,28559,453443,444448,5399,19.7,3028,11,89047,36625,52422,8.2,20,71057,27595,43462,6.2,16,17990,4,32,0,2032,2037,14418
1987,34,155661,178062,3104953,3052940,26400,15.1,18969,10.9,620845,252640,368205,8.3,20.3,516818,197860,318958,6.5,16.9,104027,3.4,33.8,0,12490,12553,86442
1987,35,25937,30459,395456,393323,4762,15.8,3983,13.2,80863,36939,43924,9.4,20.6,76597,29591,47006,7.5,19.5,4266,1.1,39,0,2608,2622,16473
1987,36,346628,394415,6817012,6761875,54505,14,44361,11.4,1147966,397057,750909,5.9,17,1037692,382727,654965,5.7,15.3,110274,1.7,30.6,0,30981,31110,201918
1987,37,109910,135635,2405053,2386113,20688,15.6,14434,10.9,418553,161334,257219,6.8,17.5,380672,139204,241468,5.8,16,37881,1.5,32,0,9271,9304,61722
1987,38,14754,17055,191699,190630,2121,12.5,1873,11,30365,12845,17520,6.7,15.9,28226,10875,17351,5.7,14.8,2139,1.1,29.6,0,1196,1205,6051
1987,39,168398,211952,3869330,3831959,28421,13.6,21450,10.3,664229,253734,410495,6.6,17.3,589487,238763,350724,6.2,15.4,74742,1.9,30.8,0,13069,13196,94202
1987,40,55906,66913,904742,925451,9326,13.8,10156,15,154095,72790,81305,7.9,16.7,195512,77998,117514,8.4,21.1,-41417,-4.4,33.4,0,6726,6804,40554
1987,41,56816,66897,892440,876674,10976,16.7,8548,13,175575,72402,103173,8.3,20,144043,62003,82040,7.1,16.4,31532,3.6,32.8,0,5622,5651,34877
1987,42,194697,236701,4255403,4213472,31890,13.7,23239,10,709959,268422,441537,6.4,16.8,626097,244650,381447,5.8,14.9,83862,1.9,29.8,0,14665,14786,108237
1987,44,20986,23375,396106,388887,3503,15.3,2391,10.5,67688,24560,43128,6.3,17.4,53250,20665,32585,5.3,13.7,14438,3.7,27.4,0,1637,1650,10956
1987,45,53780,65829,1112337,1090433,10281,15.9,7372,11.4,210562,82874,127688,7.6,19.3,166755,64871,101884,5.9,15.3,43807,4,30.6,0,4651,4690,30501
1987,46,15110,17196,200246,198213,2210,12.9,1936,11.3,32001,13054,18947,6.6,16.1,27934,11297,16637,5.7,14.1,4067,2,28.2,0,1202,1209,6409
1987,47,78062,95416,1693745,1672636,14697,15.7,10645,11.4,309647,118211,191436,7.1,18.5,267428,110920,156508,6.6,16,42219,2.5,32,0,7094,7127,49224
1987,48,273380,346439,5362803,5478631,53559,15.4,53077,15.3,1012716,464920,547796,8.5,18.5,1244371,503549,740822,9.2,22.7,-231655,-4.2,37,0,34455,34863,236982
1987,49,25703,30861,499859,496910,5003,16.4,4136,13.5,97368,38787,58581,7.8,19.6,91470,37606,53864,7.6,18.4,5898,1.2,36.8,0,2522,2566,17777
1987,50,14606,16246,214291,207875,2651,16.8,1582,10,40016,17586,22430,8.5,19.3,27184,11440,15744,5.5,13.1,12832,6.2,26.2,0,1121,1134,6760
1987,51,96910,120919,2083239,2036747,19586,16.6,12898,10.9,411814,173600,238214,8.5,20.2,318830,127224,191606,6.2,15.7,92984,4.5,31.4,0,8210,8286,53739
1987,53,88039,104588,1456112,1423544,17353,16.9,13063,12.7,305550,125737,179813,8.8,21.5,240413,98684,141729,6.9,16.9,65137,4.6,33.8,0,8351,8438,53119
1987,54,27544,32932,454067,452490,4613,14.1,3677,11.3,75278,32239,43039,7.1,16.6,72123,28172,43951,6.2,15.9,3155,0.7,31.8,0,2403,2416,14364
1987,55,86961,103018,1719907,1672556,14406,14.5,7181,7.2,286027,120480,165547,7.2,17.1,191326,60175,131151,3.6,11.4,94701,5.7,22.8,0,1857,1920,17586
1987,56,11029,12659,121689,127491,1668,13,1929,15,19601,9066,10535,7.1,15.4,31204,12301,18903,9.6,24.5,-11603,-9.1,30.8,0,1189,1197,6213
1988,1,60127,74084,1224701,1208223,9849,13.4,8894,12.1,222177,92823,129354,7.7,18.4,189220,73795,115425,6.1,15.7,32957,2.7,31.4,0,5836,5836,33259
1988,2,9723,11508,131572,133251,1816,15.7,1857,16.1,30198,12828,17370,9.6,22.7,33556,15393,18163,11.6,25.2,-3358,-2.5,45.4,0,1148,1148,6412
1988,4,58819,72779,1166476,1141415,11895,16.5,10147,14.1,263974,115487,148487,10.1,23.1,213852,87080,126772,7.6,18.7,50122,4.4,37.4,0,6765,6765,44302
1988,5,38794,45646,685823,676857,5770,12.6,5683,12.4,120542,46009,74533,6.8,17.8,102612,41044,61568,6.1,15.2,17930,2.6,30.4,0,3915,3915,19632
1988,6,505015,612479,10362365,10150042,89603,14.8,75776,12.5,2229471,823887,1405584,8.1,22,1804826,686485,1118341,6.8,17.8,424645,4.2,35.6,0,49549,49550,319255
1988,8,67976,81517,1161147,1155995,12217,15,12133,14.9,227167,93282,133885,8.1,19.7,216863,92872,123991,8,18.8,10304,0.9,37.6,0,8320,8320,45632
1988,9,70046,80878,1494376,1482486,11045,13.9,8421,10.6,262843,107293,155550,7.2,17.7,239063,95883,143180,6.5,16.1,23780,1.6,32.2,0,5705,5705,38949
1988,10,12308,14397,285576,278066,1965,13.8,1661,11.6,54592,20093,34499,7.2,19.6,39572,15908,23664,5.7,14.2,15020,5.4,28.4,0,982,982,6084
1988,11,14789,17430,414208,413840,2136,12.3,1890,10.9,70711,22456,48255,5.4,17.1,69977,20761,49216,5,16.9,734,0.2,33.8,0,1124,1124,10419
1988,12,240863,294107,4225466,4130041,48712,16.8,39612,13.7,920769,390542,530227,9.5,22.3,729919,305918,424001,7.4,17.7,190850,4.6,35.4,0,28181,28183,165886
1988,13,105908,132697,2390582,2334216,19503,14.9,15822,12.1,490924,204415,286509,8.8,21,378192,148036,230156,6.3,16.2,112732,4.8,32.4,0,10464,10467,65322
1988,15,19793,24311,382017,372876,3097,12.9,2557,10.6,71300,26173,45127,7,19.1,53018,20659,32359,5.5,14.2,18282,4.9,28.4,0,1688,1688,8967
1988,16,18127,21466,260299,254706,2757,12.9,2564,12,52318,21867,30451,8.6,20.5,41133,16859,24274,6.6,16.1,11185,4.4,32.2,0,1726,1726,9270
1988,17,192627,231250,4334950,4241323,28174,12.3,23736,10.3,767623,280496,487127,6.6,18.1,580370,218308,362062,5.1,13.7,187253,4.4,27.4,0,15499,15499,95916
1988,18,89109,109648,1979398,1950718,12976,11.9,11338,10.4,334901,122961,211940,6.3,17.2,277540,114251,163289,5.9,14.2,57361,3,28.4,0,7421,7421,62032
1988,19,52706,63812,919581,893823,6587,10.3,6565,10.3,158712,52020,106692,5.8,17.8,107197,44160,63037,4.9,12,51515,5.8,24,0,4302,4303,20527
1988,20,48567,58030,797827,786694,6992,12.1,6379,11,139573,57716,81857,7.3,17.7,117306,46335,70971,5.9,14.9,22267,2.8,29.8,0,4330,4330,24366
1988,21,56076,67573,1095497,1072390,8632,12.9,7586,11.3,198390,77395,120995,7.2,18.5,152176,60005,92171,5.6,14.2,46214,4.3,28.4,0,5324,5324,30686
1988,22,64479,79037,1169028,1157846,9602,12,10600,13.3,221656,84871,136785,7.3,19.1,199291,81797,117494,7.1,17.2,22365,1.9,34.4,0,7154,7154,40799
1988,23,25148,28908,413081,399724,4253,15,3186,11.2,79713,26720,52993,6.7,19.9,52998,19335,33663,4.8,13.3,26715,6.6,26.6,0,2191,2191,10580
1988,24,77596,94703,1727864,1697476,13496,14.5,10249,11,345747,134662,211085,7.9,20.4,284972,97146,187826,5.7,16.8,60775,3.6,33.6,0,6596,6596,47170
1988,25,119329,140079,2809669,2773491,17908,12.9,14410,10.4,496403,177543,318860,6.4,17.9,424047,153011,271036,5.5,15.3,72356,2.6,30.6,0,9539,9539,73355
1988,26,143999,175727,3209563,3185259,21555,12.3,18886,10.8,537246,208676,328570,6.6,16.9,488638,171823,316815,5.4,15.3,48608,1.6,30.6,0,12056,12056,70383
1988,27,77715,93517,1710940,1679035,11338,12.2,10005,10.8,307705,104119,203586,6.2,18.3,243895,92623,151272,5.5,14.5,63810,3.8,29,0,6376,6376,43110
1988,28,38002,45819,681683,670250,5559,12.1,5645,12.3,118870,47453,71417,7.1,17.7,96004,37209,58795,5.6,14.3,22866,3.4,28.6,0,3896,3897,19049
1988,29,91203,110835,1861755,1855037,14233,12.9,12809,11.6,325206,124961,200245,6.7,17.5,311771,136118,175653,7.3,16.8,13435,0.7,33.6,0,8420,8420,46167
1988,30,18278,21048,197246,198215,2663,12.6,2871,13.5,36033,14378,21655,7.3,18.2,37970,16566,21404,8.4,19.2,-1937,-1,36.4,0,1863,1863,8789
1988,31,32280,38081,535641,522472,4188,11,3866,10.2,96112,35657,60455,6.8,18.4,69774,28915,40859,5.5,13.4,26338,5,26.8,0,2535,2535,12417
1988,32,19613,23096,458920,445240,3879,17.1,3005,13.2,109393,41469,67924,9.3,24.6,82033,35658,46375,8,18.4,27360,6.2,36.8,0,2012,2012,14137
1988,33,25836,29330,450159,439982,4644,16.1,3529,12.2,89791,37694,52097,8.6,20.4,69437,25322,44115,5.8,15.8,20354,4.6,31.6,0,2504,2504,13498
1988,34,158596,182196,3154530,3112152,24544,13.6,19496,10.8,588884,216022,372862,6.9,18.9,504128,166416,337712,5.3,16.2,84756,2.7,32.4,0,13329,13329,70789
1988,35,25537,30288,385638,382634,4175,13.8,4078,13.4,76364,30050,46314,7.9,20,70355,28328,42027,7.4,18.4,6009,1.6,36.8,0,2753,2753,15926
1988,36,348612,398550,6864642,6812010,50773,12.8,45019,11.4,1198647,401302,797345,5.9,17.6,1093383,368541,724842,5.4,16.1,105264,1.5,32.2,0,31752,31752,171350
1988,37,111672,138754,2503889,2442074,18932,13.8,15118,11,453869,178201,275668,7.3,18.6,330239,123751,206488,5.1,13.5,123630,5.1,27,0,9817,9817,50907
1988,38,14343,16636,183296,180485,1773,10.6,1802,10.8,30471,11368,19103,6.3,16.9,24849,10415,14434,5.8,13.8,5622,3.1,27.6,0,1142,1142,5222
1988,39,170139,214695,4007784,3936881,25164,11.8,22128,10.4,689630,258486,431144,6.6,17.5,547825,194267,353558,4.9,13.9,141805,3.6,27.8,0,13477,13478,76233
1988,40,53602,64830,875764,867256,8135,12.4,9275,14.1,166348,64867,101481,7.5,19.2,149331,63771,85560,7.4,17.2,17017,2,34.4,0,6193,6193,31929
1988,41,56736,67300,910523,887587,9543,14.3,8449,12.6,185855,68747,117108,7.7,20.9,139984,58642,81342,6.6,15.8,45871,5.1,31.6,0,5723,5723,29244
1988,42,197253,240377,4355969,4297954,28576,12,23976,10.1,729045,261101,467944,6.1,17,613015,232165,380850,5.4,14.3,116030,2.7,28.6,0,15466,15469,106285
1988,44,21360,23769,401173,397852,3168,13.4,2661,11.3,68264,23266,44998,5.8,17.2,61623,23561,38062,5.9,15.5,6641,1.7,31,0,1766,1766,9857
1988,45,54529,67137,1158203,1121291,9429,14.2,7763,11.7,229426,102975,126451,9.2,20.5,155603,61062,94541,5.4,13.9,73823,6.6,27.8,0,5129,5129,27206
1988,46,14953,17064,194210,190711,1974,11.6,1860,10.9,32661,12836,19825,6.7,17.1,25663,10799,14864,5.7,13.5,6998,3.6,27,0,1203,1203,5519
1988,47,78436,96808,1742258,1702305,13371,13.9,11065,11.5,346147,152215,193932,8.9,20.3,266241,107483,158758,6.3,15.6,79906,4.7,31.2,0,7400,7400,43981
1988,48,266874,341393,5405739,5366016,47254,13.7,50120,14.6,1103716,457001,646715,8.5,20.6,1024270,425349,598921,7.9,19.1,79446,1.5,38.2,0,33956,33956,198944
1988,49,25515,30858,499583,492487,4519,14.7,4247,13.8,100639,42394,58245,8.6,20.4,86446,36747,49699,7.5,17.6,14193,2.8,35.2,0,2835,2835,18732
1988,50,14789,16487,205947,204229,2367,14.6,1815,11.2,35621,14320,21301,7,17.4,32185,12754,19431,6.2,15.8,3436,1.6,31.6,0,1281,1281,6930
1988,51,99442,124657,2159114,2105351,17898,14.6,13530,11,419226,169988,249238,8.1,19.9,311701,119259,192442,5.7,14.8,107525,5.1,29.6,0,8730,8730,47580
1988,53,88771,105965,1500309,1460996,15480,14.7,13093,12.5,322565,113357,209208,7.8,22.1,243938,97695,146243,6.7,16.7,78627,5.4,33.4,0,8498,8500,46333
1988,54,27514,32968,452579,447977,3918,11.9,3614,11,77475,30612,46863,6.8,17.3,68270,25631,42639,5.7,15.2,9205,2.1,30.4,0,2396,2396,12607
1988,55,87628,104273,1796177,1755518,11589,11.2,9946,9.6,294626,104066,190560,5.9,16.8,213307,75852,137455,4.3,12.2,81319,4.6,24.4,0,6664,6664,38150
1988,56,10765,12399,119437,119593,1496,12,1645,13.2,22086,8745,13341,7.3,18.5,22397,9284,13113,7.8,18.7,-311,-0.2,37,0,1060,1060,4752
1989,1,61295,76012,1289941,1259639,9996,13.3,8155,10.9,234054,91289,142765,7.2,18.6,173449,60955,112494,4.8,13.8,60605,4.8,27.6,0,5661,5686,34929
1989,2,8519,10390,137343,134655,1501,13.7,2625,24,36001,16330,19671,12.1,26.7,30625,17736,12889,13.2,22.7,5376,4,45.4,0,885,888,4218
1989,4,59364,73867,1205790,1187256,11488,15.7,10298,14,256742,108992,147750,9.2,21.6,219675,89525,130150,7.5,18.5,37067,3.1,37,0,6827,6863,52200
1989,5,39197,46465,718650,703077,5738,12.5,5051,11,128320,53234,75086,7.6,18.3,97174,39389,57785,5.6,13.8,31146,4.5,27.6,0,3563,3624,25412
1989,6,497370,610207,10673866,10516991,87723,14.4,90087,14.7,2214676,822292,1392384,7.8,21.1,1900927,806331,1094596,7.7,18.1,313749,3,36.2,0,48924,49254,371133
1989,8,68003,81714,1200692,1182149,11295,13.8,11062,13.6,235469,94438,141031,8,19.9,198383,87753,110630,7.4,16.8,37086,3.1,33.6,0,7367,7399,48657
1989,9,70833,82078,1511943,1500185,10100,12.4,8964,11,247366,89863,157503,6,16.5,223850,79078,144772,5.3,14.9,23516,1.6,29.8,0,6103,6147,39045
1989,10,12982,15244,304237,295075,2283,15.4,1464,9.9,58270,25806,32464,8.7,19.7,39946,10951,28995,3.7,13.5,18324,6.2,27,0,936,940,6323
1989,11,14751,17687,412286,407603,2063,11.8,1843,10.5,68833,21428,47405,5.3,16.9,59468,21543,37925,5.3,14.6,9365,2.3,29.2,0,1097,1099,10076
1989,12,246149,301899,4443204,4343009,46018,15.4,38421,12.9,937391,382018,555373,8.8,21.6,737001,292673,444328,6.7,17,200390,4.6,34,0,26776,26944,173669
1989,13,107569,135755,2465268,2432881,18773,14,15787,11.8,491484,203505,287979,8.4,20.2,426709,148135,278574,6.1,17.5,64775,2.7,35,0,10396,10448,77064
1989,15,20051,24878,404304,393312,2971,12.1,2429,9.9,72607,28876,43731,7.3,18.5,50623,19407,31216,4.9,12.9,21984,5.6,25.8,0,1615,1615,10185
1989,16,18390,21837,282776,271961,2818,13,2469,11.4,58924,23554,35370,8.7,21.7,37295,15658,21637,5.8,13.7,21629,8,27.4,0,1574,1596,9385
1989,17,195199,235637,4487126,4413213,27864,11.9,23581,10.1,753484,291427,462057,6.6,17.1,605659,209261,396398,4.7,13.7,147825,3.4,27.4,0,15224,15428,109960
1989,18,90614,112222,2086545,2037281,13104,11.8,10650,9.6,347815,123214,224601,6,17.1,249286,93581,155705,4.6,12.2,98529,4.9,24.4,0,7197,7245,53330
1989,19,53214,64652,976284,947359,6640,10.3,5844,9.1,167175,67552,99623,7.1,17.6,109324,42714,66610,4.5,11.5,57851,6.1,23,0,3993,3998,22394
1989,20,48566,58336,850786,824571,6600,11.3,6332,10.9,166384,80722,85662,9.8,20.2,113954,44148,69806,5.4,13.8,52430,6.4,27.6,0,4384,4408,26352
1989,21,56877,68884,1140943,1117882,8311,12.2,7003,10.3,197146,74191,122955,6.6,17.6,151025,58247,92778,5.2,13.5,46121,4.1,27,0,4895,4920,31698
1989,22,63632,78510,1202744,1186534,8628,11,9321,11.8,223102,81594,141508,6.9,18.8,190681,74289,116392,6.3,16.1,32421,2.7,32.2,0,6186,6229,42411
1989,23,25812,29880,427225,420316,4177,14.2,3278,11.2,77050,28096,48954,6.7,18.3,63232,23561,39671,5.6,15,13818,3.3,30,0,2275,2309,14346
1989,24,79759,97823,1767249,1748649,13048,13.6,9978,10.4,316886,123988,192898,7.1,18.1,279686,93105,186581,5.3,16,37200,2.1,32,0,6471,6498,46466
1989,25,120318,142386,2857684,2835543,16696,11.8,14842,10.5,479879,169026,310853,6,16.9,435597,140873,294724,5,15.4,44282,1.5,30.8,0,10202,10374,76986
1989,26,146936,180346,3332849,3273064,21675,12.2,17330,9.7,555847,192256,363591,5.9,17,436276,144483,291793,4.4,13.3,119571,3.7,26.6,0,11610,11677,80306
1989,27,79177,95717,1770723,1741130,11430,12.1,9205,9.7,292148,108150,183998,6.2,16.8,232962,93002,139960,5.3,13.4,59186,3.4,26.8,0,5974,6011,43493
1989,28,38166,46427,704963,696057,5596,12.1,5060,11,118582,46333,72249,6.7,17,100770,40054,60716,5.8,14.5,17812,2.5,29,0,3515,3547,22425
1989,29,92882,113340,1935843,1899715,14257,12.7,11752,10.5,340026,120371,219655,6.3,17.9,267771,96137,171634,5.1,14.1,72255,3.8,28.2,0,7936,7998,53562
1989,30,18444,21240,207542,202334,2702,12.8,2462,11.6,39880,16148,23732,8,19.7,29463,11905,17558,5.9,14.6,10417,5.1,29.2,0,1639,1641,7672
1989,31,32503,38563,558531,547129,4278,11.2,3777,9.9,93388,34165,59223,6.2,17.1,70583,27583,43000,5,12.9,22805,4.2,25.8,0,2526,2536,15481
1989,32,20661,24378,496397,478072,4146,17.5,2853,12,116291,41035,75256,8.6,24.3,79642,33525,46117,7,16.7,36649,7.6,33.4,0,1860,1868,17097
1989,33,25965,29717,459809,455866,4080,13.8,3707,12.6,79429,34420,45009,7.6,17.4,71542,26210,45332,5.7,15.7,7887,1.7,31.4,0,2715,2741,17045
1989,34,159959,184803,3208743,3185210,22971,12.5,20520,11.2,570255,208256,361999,6.5,17.9,523189,170232,352957,5.3,16.4,47066,1.5,32.8,0,13694,13750,89071
1989,35,25776,30714,394265,390043,4242,13.9,3853,12.6,75479,30627,44852,7.9,19.4,67035,25516,41519,6.5,17.2,8444,2.2,34.4,0,2568,2586,15550
1989,36,351791,404413,6985567,6922938,50617,12.6,45369,11.3,1150283,412053,738230,6,16.6,1025026,351511,673515,5.1,14.8,125257,1.8,29.6,0,31587,31772,195928
1989,37,114398,142582,2591753,2556062,18291,13,14564,10.4,436546,170177,266369,6.7,17.1,365164,119272,245892,4.7,14.3,71382,2.8,28.6,0,9467,9525,58888
1989,38,14371,16750,187125,184821,1660,9.9,1554,9.3,28811,11648,17163,6.3,15.6,24202,9362,14840,5.1,13.1,4609,2.5,26.2,0,1069,1072,5263
1989,39,172493,219062,4163651,4094191,24725,11.4,20514,9.5,698748,266938,431810,6.5,17.1,559828,206597,353231,5,13.7,138920,3.4,27.4,0,13321,13441,92444
1989,40,53840,65212,904493,891187,8226,12.7,7917,12.2,165361,62877,102484,7.1,18.6,138748,58683,80065,6.6,15.6,26613,3,31.2,0,5432,5468,34900
1989,41,51221,61998,925941,919294,8211,12.7,13457,20.8,200494,67622,132872,7.4,21.8,187200,112221,74979,12.2,20.4,13294,1.4,40.8,0,5145,5180,31828
1989,42,201149,245930,4473199,4409135,28206,11.6,22823,9.4,712965,259129,453836,5.9,16.2,584836,213088,371748,4.8,13.3,128129,2.9,26.6,0,14986,15158,105868
1989,44,21798,24359,405968,404567,3143,13.1,2640,11,66643,27927,38716,6.9,16.5,63841,22657,41184,5.6,15.8,2802,0.7,31.6,0,1893,1920,14519
1989,45,55593,68789,1201854,1182357,8871,13.1,7260,10.7,209270,81053,128217,6.9,17.7,170276,67391,102885,5.7,14.4,38994,3.3,28.8,0,4855,4872,36461
1989,46,15129,17339,203026,198666,1894,11,1591,9.3,34070,11291,22779,5.7,17.1,25349,9753,15596,4.9,12.8,8721,4.3,25.6,0,1116,1116,5681
1989,47,79651,99299,1827483,1789613,12910,13.2,10605,10.8,337475,129003,208472,7.2,18.9,261734,97324,164410,5.4,14.6,75741,4.3,29.2,0,7196,7340,56820
1989,48,265408,340868,5596512,5509085,44500,13,45298,13.3,1139343,436794,702549,7.9,20.7,964489,408979,555510,7.4,17.5,174854,3.2,35,0,29651,30023,226544
1989,49,25490,31024,537324,520427,4151,13.4,3981,12.9,116890,47040,69850,9,22.5,83098,34173,48925,6.6,16,33792,6.5,32,0,2576,2658,19902
1989,50,15272,17098,217654,212357,2446,14.6,1860,11.1,36995,14845,22150,7,17.4,26401,10552,15849,5,12.4,10594,5,24.8,0,1366,1391,7118
1989,51,101867,128725,2256564,2210711,17503,13.8,13561,10.7,408321,164535,243786,7.4,18.5,316616,110307,206309,5,14.3,91705,4.2,28.6,0,8823,8903,56537
1989,53,75540,93100,1557684,1530239,12979,13,25701,25.8,386580,114351,272229,7.5,25.3,331690,202574,129116,13.2,21.7,54890,3.6,43.4,0,8112,8170,54996
1989,54,27717,33395,468516,461869,3805,11.5,3395,10.2,77872,33674,44198,7.3,16.9,64577,23560,41017,5.1,14,13295,2.9,28,0,2319,2331,13894
1989,55,88780,106233,1870617,1834629,11776,11.2,9824,9.3,296383,94981,201402,5.2,16.2,224408,82814,141594,4.5,12.2,71975,4,24.4,0,6536,6573,44682
1989,56,10705,12376,123582,121529,1430,11.5,1431,11.6,23176,8534,14642,7,19.1,19071,7199,11872,5.9,15.7,4105,3.4,31.4,0,932,937,4581
1990,1,62171,77182,1330290,1308731,9461,12.4,7846,10.2,217203,72705,144498,5.6,16.6,174085,59024,115061,4.5,13.3,43118,3.3,26.6,0,5516,5565,35552
1990,2,10162,12103,153787,143536,2830,25.2,1072,9.5,43001,22228,20773,15.5,30,22499,7288,15211,5.1,15.7,20502,14.3,31.4,0,648,649,4045
1990,4,60361,75111,1222382,1212136,11268,15.1,9402,12.6,238181,95121,143060,7.8,19.6,217689,79121,138568,6.5,18,20492,1.6,36,0,6365,6416,43173
1990,5,39969,47408,745443,731553,5861,12.5,4609,9.8,120279,42226,78053,5.8,16.4,92499,29129,63370,4,12.6,27780,3.8,25.2,0,3319,3321,17988
1990,6,526681,643031,11171471,10911099,104625,16.7,67352,10.8,2287384,921038,1366346,8.4,21,1766641,619980,1146661,5.7,16.2,520743,4.8,32.4,0,45319,45523,342840
1990,8,69476,83452,1239572,1219969,11779,14.3,9554,11.6,229305,93539,135766,7.7,18.8,190099,79908,110191,6.6,15.6,39206,3.2,31.2,0,6444,6478,45973
1990,9,70307,81892,1486832,1497465,9044,11,8637,10.5,202640,75069,127571,5,13.5,223907,69658,154249,4.7,15,-21267,-1.5,27,0,5975,6018,37868
1990,10,13463,15875,313624,308860,2157,13.9,1446,9.3,46935,14863,32072,4.8,15.2,37406,10086,27320,3.3,12.1,9529,3.1,24.2,0,958,958,5745
1990,11,14505,17483,408758,410753,1880,10.7,1969,11.2,57201,18173,39028,4.4,13.9,61191,17521,43670,4.3,14.9,-3990,-1,27.8,0,1237,1241,7679
1990,12,251930,309640,4552950,4489028,46606,15.2,36573,12,886622,364124,522498,8.1,19.8,758778,284929,473849,6.3,16.9,127844,2.9,33.8,0,26345,26498,171776
1990,13,108536,137604,2513144,2488102,17807,13,15066,11,443797,160865,282932,6.5,17.8,393713,138070,255643,5.5,15.8,50084,2,31.6,0,10130,10190,69739
1990,15,20784,25766,426699,415016,3229,12.8,2198,8.7,74030,28049,45981,6.8,17.8,50663,18466,32197,4.4,12.2,23367,5.6,24.4,0,1418,1421,11112
1990,16,19560,23126,296458,289288,3397,15.1,1992,8.9,55216,19214,36002,6.6,19.1,40876,13532,27344,4.7,14.1,14340,5,28.2,0,1390,1399,8564
1990,17,199038,240336,4590731,4536484,27456,11.5,21639,9.1,693236,245873,447363,5.4,15.3,584743,186751,397992,4.1,12.9,108493,2.4,25.8,0,14414,14475,98195
1990,18,92284,114686,2132091,2106962,13037,11.5,10018,8.8,313631,108518,205113,5.2,14.9,263373,82026,181347,3.9,12.5,50258,2.4,25,0,6926,6955,44834
1990,19,53914,65683,1006784,991617,6584,10.1,5322,8.2,142093,46056,96037,4.6,14.3,111759,34764,76995,3.5,11.3,30334,3,22.6,0,3705,3718,21914
1990,20,48659,58546,878510,864085,6532,11.2,6006,10.3,139676,49855,89821,5.8,16.2,110825,41378,69447,4.8,12.8,28851,3.4,25.6,0,4142,4156,23465
1990,21,58009,70400,1180688,1158873,8553,12.3,6667,9.6,195182,72690,122492,6.3,16.8,151552,52323,99229,4.5,13.1,43630,3.7,26.2,0,4701,4715,30148
1990,22,64003,79069,1250121,1224461,9014,11.4,8098,10.3,227256,80427,146829,6.6,18.6,175935,68372,107563,5.6,14.4,51321,4.2,28.8,0,5510,5562,38259
1990,23,25485,29625,414576,420093,3451,11.6,3416,11.5,58895,23782,35113,5.7,14,69928,21729,48199,5.2,16.6,-11033,-2.6,28,0,2405,2410,13710
1990,24,81799,100508,1806290,1785578,12847,13,9703,9.8,310401,112681,197720,6.3,17.4,268976,89875,179101,5,15.1,41425,2.3,30.2,0,6285,6319,47001
1990,25,117553,140123,2743403,2799885,14557,10.3,15630,11.1,359588,129963,229625,4.6,12.8,472553,145101,327452,5.2,16.9,-112965,-4.1,25.6,0,10849,10910,80962
1990,26,149247,183630,3375074,3352894,20907,11.5,16675,9.2,509106,185134,323972,5.5,15.2,464745,140616,324129,4.2,13.9,44361,1.3,27.8,0,11305,11367,73301
1990,27,81098,97865,1824021,1795631,11242,11.6,8686,9,286298,92088,194210,5.1,15.9,229518,80422,149096,4.5,12.8,56780,3.1,25.6,0,5610,5645,39263
1990,28,38570,46936,726135,714876,5626,12.1,4827,10.3,116624,40234,76390,5.6,16.3,94107,33947,60160,4.7,13.2,22517,3.1,26.4,0,3407,3429,19880
1990,29,94530,115310,1968979,1950997,13704,12,11138,9.7,304119,111129,192990,5.7,15.6,268155,85122,183033,4.4,13.7,35964,1.9,27.4,0,7455,7488,45711
1990,30,18827,21665,218374,213460,2599,12.1,2073,9.7,38220,13184,25036,6.2,17.9,28391,11136,17255,5.2,13.3,9829,4.6,26.6,0,1382,1383,6907
1990,31,32953,39114,579236,568586,4159,10.7,3407,8.8,85507,29459,56048,5.2,15,64207,21485,42722,3.8,11.3,21300,3.7,22.6,0,2272,2273,12667
1990,32,21813,25734,536498,516079,4280,17.1,2740,10.9,115923,36339,79584,7,22.5,75086,25914,49172,5,14.5,40837,8,29,0,1914,1923,15950
1990,33,25119,28967,444900,455350,3520,12,3955,13.5,61732,24655,37077,5.4,13.6,82631,27967,54664,6.1,18.1,-20899,-4.5,27.2,0,2887,2889,17457
1990,34,159966,185631,3196486,3201094,21527,11.6,19303,10.4,502198,188041,314157,5.9,15.7,511415,163220,348195,5.1,16,-9217,-0.3,31.4,0,13365,13398,82304
1990,35,26287,31238,410321,401588,4158,13.4,3403,11,76688,28787,47901,7.2,19.1,59221,23113,36108,5.8,14.7,17467,4.4,29.4,0,2244,2256,13288
1990,36,352054,406100,6991175,6982390,47009,11.6,42873,10.6,1051181,357855,693326,5.1,15.1,1033611,332606,701005,4.8,14.8,17570,0.3,29.6,0,31050,31185,187326
1990,37,117035,146095,2667795,2627784,18227,12.6,13776,9.5,433028,152444,280584,5.8,16.5,353005,125368,227637,4.8,13.4,80023,3.1,26.8,0,9367,9414,68493
1990,38,14449,16855,193806,190485,1668,9.9,1460,8.7,28074,8841,19233,4.6,14.7,21432,7876,13556,4.1,11.3,6642,3.4,22.6,0,1044,1045,4778
1990,39,174606,222405,4227450,4194809,23742,10.8,19488,8.8,607368,215026,392342,5.1,14.5,542087,170562,371525,4.1,12.9,65281,1.6,25.8,0,12961,13045,95668
1990,40,54500,65915,939348,921625,8065,12.3,7014,10.7,160124,57357,102767,6.2,17.4,124677,47698,76979,5.2,13.5,35447,3.9,27,0,4820,4832,27957
1990,41,59217,70407,1002648,963299,14983,22.6,6195,9.4,230000,122375,107625,12.7,23.9,151302,50415,100887,5.2,15.7,78698,8.2,31.4,0,4129,4160,27879
1990,42,204263,250276,4556025,4516642,26966,10.9,21437,8.6,652374,210308,442066,4.7,14.4,573609,178330,395279,3.9,12.7,78765,1.7,25.4,0,14594,14652,97090
1990,44,21631,24233,392381,398523,2690,11.1,2605,10.7,52906,20338,32568,5.1,13.3,65189,19476,45713,4.9,16.4,-12283,-3.1,26.6,0,1883,1884,10864
1990,45,56680,70208,1247481,1224308,8823,12.7,6909,9.9,206348,74946,131402,6.1,16.9,160004,54731,105273,4.5,13.1,46344,3.8,26.2,0,4751,4770,30049
1990,46,15537,17807,212510,207032,2133,12.1,1542,8.8,36486,13894,22592,6.7,17.6,25529,10083,15446,4.9,12.3,10957,5.3,24.6,0,1081,1082,5460
1990,47,80503,100754,1863350,1845362,12361,12.4,10254,10.3,296194,108861,187333,5.9,16.1,260218,87363,172855,4.7,14.1,35976,2,28.2,0,7048,7064,45459
1990,48,270028,346795,5801723,5694592,46669,13.6,38758,11.3,1130054,424877,705177,7.5,19.8,915792,368308,547484,6.5,16.1,214262,3.7,32.2,0,25953,26219,186170
1990,49,26116,31764,564444,550264,4212,13.4,3227,10.3,106132,36577,69555,6.6,19.3,77771,29328,48443,5.3,14.1,28361,5.2,28.2,0,2159,2171,16072
1990,50,15339,17217,215680,216103,2032,11.8,1789,10.4,31818,11695,20123,5.4,14.7,32664,11001,21663,5.1,15.1,-846,-0.4,29.4,0,1328,1330,6393
1990,51,104394,132453,2309264,2281896,17369,13.3,12916,9.9,384863,143798,241065,6.3,16.9,330126,106502,223624,4.7,14.5,54737,2.4,29,0,8587,8642,53345
1990,53,94823,113456,1710147,1633815,29727,28.8,8908,8.6,446590,240697,205893,14.7,27.3,293926,128246,165680,7.8,18,152664,9.3,36,0,5723,5747,76963
1990,54,27979,33778,482551,475208,3838,11.4,3178,9.5,76508,27523,48985,5.8,16.1,61821,22682,39139,4.8,13,14687,3.1,26,0,2258,2263,13958
1990,55,90589,108579,1930615,1900815,11797,11,8970,8.4,276431,97272,179159,5.1,14.5,216832,71190,145642,3.7,11.4,59599,3.1,22.8,0,6099,6129,38512
1990,56,10873,12540,129560,126503,1484,11.9,1252,10.1,24182,8150,16032,6.4,19.1,18068,7545,10523,6,14.3,6114,4.8,28.6,0,823,824,3949
1991,1,63028,78779,1333680,1331346,9755,12.5,8231,10.6,213517,89496,124021,6.7,16,208848,73331,135517,5.5,15.7,4669,0.3,31.4,0,5181,5244,36668
1991,2,10631,12748,160154,156394,1935,15.6,1264,10.2,34316,12961,21355,8.3,21.9,26796,7987,18809,5.1,17.1,7520,4.8,34.2,0,725,727,4229
1991,4,62142,77626,1248331,1235232,11787,15.4,9236,12.1,254663,109970,144693,8.9,20.6,228466,80755,147711,6.5,18.5,26197,2.1,37,0,5808,5868,45426
1991,5,40727,48682,762974,754012,6169,12.8,4927,10.3,125512,54187,71325,7.2,16.6,107588,34993,72595,4.6,14.3,17924,2.3,28.6,0,3246,3269,20028
1991,6,536168,659322,10922525,11045948,92342,14.2,75950,11.7,1960687,792417,1168270,7.2,17.8,2207534,718687,1488847,6.5,20,-246847,-2.2,35.6,0,47151,47675,389984
1991,8,72211,86999,1272153,1255700,12837,15.1,9336,11,234806,98910,135896,7.9,18.7,201901,75713,126188,6,16.1,32905,2.6,32.2,0,5977,6065,41544
1991,9,68854,80895,1443228,1465067,8499,10.4,9426,11.6,204944,85644,119300,5.8,14,248622,76463,172159,5.2,17,-43678,-3,28,0,6022,6077,38523
1991,10,13869,16552,311545,312349,2285,14.1,1626,10,48819,22844,25975,7.3,15.6,50427,16630,33797,5.3,16.1,-1608,-0.5,31.2,0,971,985,5944
1991,11,14624,17567,389257,398837,1978,11.3,1911,10.9,51251,19412,31839,4.9,12.9,70410,18287,52123,4.6,17.7,-19159,-4.8,25.8,0,966,983,8054
1991,12,258066,318388,4530276,4542314,48474,15.4,39736,12.7,870057,394350,475707,8.7,19.2,894135,317417,576718,7,19.7,-24078,-0.5,38.4,0,25565,25913,179903
1991,13,110848,141138,2449728,2480130,19220,13.8,15751,11.3,417498,184040,233458,7.4,16.8,478302,173722,304580,7,19.3,-60804,-2.5,33.6,0,9459,9672,92719
1991,15,21517,26945,436813,432403,3537,13.4,2373,9,75115,32918,42197,7.6,17.4,66294,19388,46906,4.5,15.3,8821,2.1,30.6,0,1493,1510,10267
1991,16,20276,24050,307021,301539,3230,13.7,2264,9.6,57380,22238,35142,7.4,19,46416,15374,31042,5.1,15.4,10964,3.6,30.8,0,1384,1393,8255
1991,17,201876,245440,4572816,4579422,28366,11.7,23345,9.6,672358,272887,399471,6,14.7,685570,211597,473973,4.6,15,-13212,-0.3,29.4,0,14486,14652,109377
1991,18,93879,117562,2108543,2118857,13605,11.7,10692,9.2,298503,122831,175672,5.8,14.1,319131,95136,223995,4.5,15.1,-20628,-1,28.2,0,6932,7015,53015
1991,19,54931,67400,1028514,1017917,7047,10.6,5351,8,147879,51196,96683,5,14.5,126685,37753,88932,3.7,12.4,21194,2.1,24.8,0,3421,3457,20818
1991,20,49002,59387,878781,878200,7034,11.9,6151,10.4,136226,59152,77074,6.7,15.5,135063,46123,88940,5.3,15.4,1163,0.1,30.8,0,3866,3918,25699
1991,21,58792,72162,1184762,1181918,8789,12.3,6998,9.8,187935,79217,108718,6.7,15.9,182246,59595,122651,5,15.4,5689,0.5,30.8,0,4686,4722,35659
1991,22,65093,80989,1274876,1262596,9713,12.1,7926,9.9,229354,86502,142852,6.9,18.2,204793,75306,129487,6,16.2,24561,2,32.4,0,5071,5119,39124
1991,23,25193,29571,396269,405169,3365,11.4,3308,11.2,51732,21144,30588,5.2,12.8,69533,20414,49119,5,17.2,-17801,-4.4,25.6,0,2102,2109,11487
1991,24,82237,101907,1736408,1770799,12654,12.5,11204,11.1,269540,117072,152468,6.6,15.2,338323,109931,228392,6.2,19.1,-68783,-3.9,30.4,0,6826,6912,51723
1991,25,114183,137529,2572458,2653468,14171,10.2,16642,12,333512,129224,204288,4.9,12.6,495533,157731,337802,5.9,18.7,-162021,-6.1,25.2,0,10172,10315,77141
1991,26,150932,186796,3278002,3325478,21023,11.4,17843,9.6,462188,192199,269989,5.8,13.9,557140,163982,393158,4.9,16.8,-94952,-2.9,27.8,0,11306,11480,87322
1991,27,82945,100900,1805171,1815345,12214,12.3,9123,9.2,268353,112686,155667,6.2,14.8,288701,98025,190676,5.4,15.9,-20348,-1.1,29.6,0,5638,5720,52955
1991,28,39177,48007,734356,730048,5893,12.4,4932,10.4,116199,48492,67707,6.6,15.9,107583,35679,71904,4.9,14.7,8616,1.2,29.4,0,3126,3148,20656
1991,29,95632,117402,1984741,1975291,14210,12.2,12102,10.4,328623,119749,208874,6.1,16.6,309723,105596,204127,5.3,15.7,18900,0.9,31.4,0,7551,7654,54627
1991,30,19339,22358,221800,220091,2819,12.8,2113,9.6,37263,15942,21321,7.2,16.9,33845,11205,22640,5.1,15.4,3418,1.5,30.8,0,1397,1408,7192
1991,31,33538,40183,593879,586407,4516,11.4,3465,8.7,88668,35523,53145,6.1,15.1,73723,23841,49882,4.1,12.6,14945,2.5,25.2,0,2232,2265,14504
1991,32,22949,27248,546109,541999,4524,17.1,2990,11.3,101325,39704,61621,7.3,18.7,93105,27415,65690,5.1,17.2,8220,1.5,34.4,0,1937,1954,17742
1991,33,24452,28488,411184,423838,3456,12,3839,13.4,56906,25322,31584,6,13.4,82214,28606,53608,6.7,19.4,-25308,-6,26.8,0,2494,2518,17075
1991,34,158016,184436,3059207,3123777,20932,11.3,21799,11.8,451598,175721,275877,5.6,14.5,580738,178829,401909,5.7,18.6,-129140,-4.1,29,0,13613,13723,87075
1991,35,27137,32380,425464,418013,4604,14.5,3469,10.9,84307,39279,45028,9.4,20.2,69404,27082,42322,6.5,16.6,14903,3.6,33.2,0,2117,2130,14624
1991,36,350626,407371,6723520,6860241,47202,11.6,46341,11.4,940673,372099,568574,5.4,13.7,1214117,369223,844894,5.4,17.7,-273444,-4,27.4,0,31059,31231,203513
1991,37,118431,148798,2568623,2614109,18174,12.3,15413,10.5,360268,152167,208101,5.8,13.8,451241,143070,308171,5.5,17.3,-90973,-3.5,27.6,0,9701,9835,69824
1991,38,14590,17149,200236,197321,1832,10.8,1542,9.1,31975,13400,18575,6.8,16.2,26144,8850,17294,4.5,13.2,5831,3,26.4,0,976,980,5566
1991,39,176412,225998,4160361,4192393,24194,10.8,20406,9.1,569477,223910,345567,5.3,13.6,633540,197336,436204,4.7,15.1,-64063,-1.5,27.2,0,12639,12768,103638
1991,40,56091,67984,950270,944837,8759,13.1,6748,10.1,158767,66927,91840,7.1,16.8,147901,50771,97130,5.4,15.7,10866,1.1,31.4,0,4321,4356,28686
1991,41,60751,72758,1023291,1011957,10205,14.3,7719,10.8,190262,78818,111444,7.8,18.8,167594,59924,107670,5.9,16.6,22668,2.2,33.2,0,4874,4962,31017
1991,42,205850,253718,4511679,4540484,26780,10.6,23306,9.3,625811,242892,382919,5.3,13.8,683421,222858,460563,4.9,15.1,-57610,-1.3,27.6,0,14765,15000,107959
1991,44,21110,23747,375139,383761,2447,10.2,2896,12.1,50554,21573,28981,5.6,13.2,67800,19699,48101,5.1,17.7,-17246,-4.5,26.4,0,1836,1856,11803
1991,45,58051,72509,1229439,1237652,9602,13.5,7277,10.2,190792,89521,101271,7.2,15.4,207218,66086,141132,5.3,16.7,-16426,-1.3,30.8,0,4485,4534,32218
1991,46,15997,18504,225154,219151,2238,12.3,1530,8.4,39036,16115,22921,7.4,17.8,27030,8604,18426,3.9,12.3,12006,5.5,24.6,0,991,992,5268
1991,47,81757,103168,1848361,1854758,12987,12.7,10588,10.4,296654,131515,165139,7.1,16,309447,100786,208661,5.4,16.7,-12793,-0.7,32,0,6710,6787,53000
1991,48,277957,357984,5924561,5860895,50260,14.3,39095,11.1,1148594,471416,677178,8,19.6,1021262,393432,627830,6.7,17.4,127332,2.2,34.8,0,24141,24525,214520
1991,49,27246,33230,594683,579723,4744,14.6,3314,10.2,116986,44260,72726,7.6,20.2,87065,30329,56736,5.2,15,29921,5.2,30,0,2065,2082,18752
1991,50,15267,17256,205810,210832,1870,10.8,1831,10.6,26718,11301,15417,5.4,12.7,36761,11131,25630,5.3,17.4,-10043,-4.7,25.4,0,1192,1197,6894
1991,51,104850,134175,2222788,2265881,16907,12.7,15048,11.3,332750,146086,186664,6.4,14.7,418935,134042,284893,5.9,18.5,-86185,-3.8,29.4,0,9028,9143,62809
1991,53,98435,118516,1738486,1727386,17274,14.9,12119,10.5,320138,121517,198621,7,18.5,297939,104387,193552,6,17.2,22199,1.3,34.4,0,7447,7521,48602
1991,54,28340,34486,482945,481710,3998,11.7,3264,9.6,73591,33468,40123,6.9,15.3,71120,22052,49068,4.6,14.8,2471,0.5,29.6,0,2053,2074,13525
1991,55,92429,111775,1938998,1933910,12482,11.3,9277,8.4,263782,102710,161072,5.3,13.6,253606,76294,177312,3.9,13.1,10176,0.5,26.2,0,6026,6117,43287
1991,56,11264,13063,134962,132224,1692,13.2,1181,9.2,24585,9208,15377,7,18.6,19108,5774,13334,4.4,14.5,5477,4.1,29,0,760,763,3867
1992,1,63970,80336,1357362,1346280,10070,12.6,8236,10.3,220372,76505,143867,5.7,16.4,198207,67104,131103,5,14.7,22165,1.7,29.4,0,5499,5579,37450
1992,2,10879,13231,164382,162104,1963,15.1,1415,10.9,35961,12356,23605,7.6,22.2,31404,9618,21786,5.9,19.4,4557,2.8,38.8,0,847,861,5610
1992,4,63156,78886,1249899,1248202,11682,14.9,10046,12.8,246717,99573,147144,8,19.8,243324,98751,144573,7.9,19.5,3393,0.3,39,0,6261,6440,43042
1992,5,41274,49603,783343,773180,6375,13,5216,10.6,132518,44117,88401,5.7,17.1,112191,38196,73995,4.9,14.5,20327,2.6,29,0,3562,3618,21315
1992,6,529989,656838,10598897,10735900,87458,13.3,85195,12.9,1973884,802905,1170979,7.5,18.4,2247890,799637,1448253,7.4,20.9,-274006,-2.5,36.8,0,54705,55700,437100
1992,8,74163,89232,1315478,1292783,12988,14.7,10336,11.7,254184,100189,153995,7.7,19.7,208794,84909,123885,6.6,16.2,45390,3.5,32.4,0,6501,6615,45009
1992,9,67370,79650,1406205,1424209,8418,10.5,9146,11.4,197562,68776,128786,4.8,13.9,233570,72254,161316,5.1,16.4,-36008,-2.5,27.8,0,5837,5916,36640
1992,10,14037,16885,301583,306321,2290,13.7,1877,11.2,44661,16936,27725,5.5,14.6,54136,20758,33378,6.8,17.7,-9475,-3.1,29.2,0,1079,1085,6206
1992,11,14643,17719,403695,396517,1985,11.2,1786,10.1,72593,36155,36438,9.1,18.3,58237,16632,41605,4.2,14.7,14356,3.6,29.4,0,1001,1015,8118
1992,12,263316,324801,4562736,4547078,50529,15.7,42427,13.2,908070,386794,521276,8.5,20,876755,362386,514369,8,19.3,31315,0.7,38.6,0,28036,28568,187058
1992,13,113185,144003,2504354,2476669,20170,14.1,16682,11.7,467998,179007,288991,7.2,18.9,412628,169470,243158,6.8,16.7,55370,2.2,33.4,0,10237,10472,79033
1992,15,21472,27175,447067,441929,3148,11.6,2795,10.3,76867,25460,51407,5.8,17.4,66590,20494,46096,4.6,15.1,10277,2.3,30.2,0,1760,1792,10287
1992,16,21101,25043,325529,316441,3599,14.6,2499,10.2,65488,26900,38588,8.5,20.7,47312,16101,31211,5.1,15,18176,5.7,30,0,1592,1612,9549
1992,17,203248,248395,4619308,4586777,28625,11.6,24615,10,768497,286640,481857,6.2,16.8,703434,225637,477797,4.9,15.3,65063,1.5,30.6,0,15154,15410,109008
1992,18,94837,119640,2154912,2130826,13667,11.5,11242,9.5,344527,128233,216294,6,16.2,296356,98666,197690,4.6,13.9,48171,2.3,27.8,0,7286,7412,51978
1992,19,55401,68380,1027620,1023829,7157,10.5,5952,8.8,156090,56942,99148,5.6,15.2,148508,47041,101467,4.6,14.5,7582,0.7,29,0,3823,3877,24025
1992,20,49562,60402,887496,882838,7196,12,5951,9.9,141575,54319,87256,6.2,16,132259,46090,86169,5.2,15,9316,1,30,0,3834,3897,26726
1992,21,59157,73064,1199890,1193344,8702,12,7551,10.4,181524,62842,118682,5.3,15.2,168432,58732,109700,4.9,14.1,13092,1.1,28.2,0,5117,5177,33808
1992,22,65909,82228,1296475,1284862,9883,12.1,8325,10.2,238614,81121,157493,6.3,18.6,215388,74433,140955,5.8,16.8,23226,1.8,33.6,0,5298,5428,40233
1992,23,24995,29488,387662,391399,3380,11.4,3249,11,56256,21120,35136,5.4,14.4,63729,22774,40955,5.8,16.3,-7473,-1.9,28.8,0,2054,2093,10969
1992,24,82819,103180,1711990,1723661,12739,12.4,11142,10.8,285784,107991,177793,6.3,16.6,309126,97387,211739,5.7,17.9,-23342,-1.3,33.2,0,6609,6755,46573
1992,25,112515,136613,2544508,2557668,14731,10.7,14955,10.9,383771,135069,248702,5.3,15,410091,135786,274305,5.3,16,-26320,-1,30,0,9271,9426,66267
1992,26,152449,189565,3328046,3302409,21188,11.2,17667,9.4,520595,167419,353176,5.1,15.8,469321,150720,318601,4.6,14.2,51274,1.6,28.4,0,10684,10840,76021
1992,27,83958,102683,1844340,1823470,12145,11.9,9974,9.8,291674,98238,193436,5.4,16,249933,87497,162436,4.8,13.7,41741,2.3,27.4,0,6209,6329,44070
1992,28,39488,48479,739675,734590,5818,12.1,5095,10.6,117279,37682,79597,5.1,16,107109,35525,71584,4.8,14.6,10170,1.4,29.2,0,3320,3360,20008
1992,29,96442,118740,1993421,1987365,14257,12.1,12453,10.5,310777,108059,202718,5.4,15.6,298666,97871,200795,4.9,15,12111,0.6,30,0,7923,8052,48977
1992,30,19822,23104,235852,228653,3101,13.6,2306,10.1,45604,15318,30286,6.7,19.9,31206,12145,19061,5.3,13.6,14398,6.3,27.2,0,1535,1550,7917
1992,31,33981,40815,600075,594998,4498,11.1,3707,9.1,89779,30217,59562,5.1,15.1,79624,25456,54168,4.3,13.4,10155,1.7,26.8,0,2368,2413,14043
1992,32,23421,28081,546371,546299,4575,16.5,3596,13,92343,39368,52975,7.2,16.9,92199,30487,61712,5.6,16.9,144,0,33.8,0,2343,2367,16144
1992,33,24217,28597,413122,411848,3623,12.7,3337,11.7,67905,25663,42242,6.2,16.5,65357,22548,42809,5.5,15.9,2548,0.6,31.8,0,2252,2294,13944
1992,34,157114,183930,3040386,3043996,21095,11.4,20406,11.1,502488,159289,343199,5.2,16.5,509708,163963,345745,5.4,16.7,-7220,-0.2,33,0,12845,12981,73127
1992,35,27515,33072,436178,429393,4600,14,3680,11.2,89935,34447,55488,8,20.9,76364,27598,48766,6.4,17.8,13571,3.1,35.6,0,2279,2323,13990
1992,36,345609,403494,6669755,6677852,46093,11.4,47415,11.7,1076449,381884,694565,5.7,16.1,1092642,368767,723875,5.5,16.4,-16193,-0.3,32.2,0,32528,33012,197243
1992,37,119218,150669,2626865,2596098,17965,12,15391,10.3,425098,149053,276045,5.7,16.4,363565,131964,231601,5.1,14,61533,2.4,28,0,9815,9963,60527
1992,38,14582,17292,205027,202338,1869,10.8,1631,9.5,31796,11239,20557,5.6,15.7,26418,9012,17406,4.5,13.1,5378,2.6,26.2,0,1048,1061,5146
1992,39,176800,227789,4162051,4158423,23912,10.5,21562,9.5,593992,195480,398512,4.7,14.3,586736,181572,405164,4.4,14.1,7256,0.2,28.2,0,13227,13472,86209
1992,40,56658,69097,953545,951042,8821,12.9,7426,10.8,160305,59712,100593,6.3,16.9,155299,59048,96251,6.2,16.3,5006,0.6,32.6,0,5048,5138,31651
1992,41,62028,74539,1025215,1022799,10188,13.8,8061,10.9,178723,68368,110355,6.7,17.5,173891,59412,114479,5.8,17,4832,0.5,34,0,5134,5199,32905
1992,42,204484,253813,4476415,4490870,25672,10.1,24744,9.7,636401,227449,408952,5.1,14.2,665311,215313,449998,4.8,14.8,-28910,-0.6,28.4,0,15877,16130,103265
1992,44,20706,23358,363026,368153,2590,11,2733,11.6,52461,18577,33884,5,14.2,62716,22251,40465,6,17,-10255,-2.8,28.4,0,1776,1804,12308
1992,45,58640,73489,1251429,1241678,9243,12.6,7889,10.8,199131,75361,123770,6.1,16,179629,59002,120627,4.8,14.5,19502,1.5,29,0,5060,5129,32552
1992,46,16170,18842,234272,229578,2233,11.9,1832,9.8,40070,13715,26355,6,17.5,30681,11559,19122,5,13.4,9389,4.1,26.8,0,1186,1197,6949
1992,47,82620,104558,1893530,1869175,13078,12.6,11262,10.8,321384,108522,212862,5.8,17.2,272674,99977,172697,5.3,14.6,48710,2.6,29.2,0,7139,7253,49319
1992,48,283242,365965,5997090,5953484,51703,14.3,42232,11.7,1157567,470625,686942,7.9,19.4,1070356,399111,671245,6.7,18,87211,1.4,36,0,26576,27223,206612
1992,49,28203,34364,612863,603533,5019,14.8,3793,11.2,118640,43783,74857,7.3,19.7,99981,41206,58775,6.8,16.6,18659,3.1,33.2,0,2414,2449,23583
1992,50,15202,17236,207023,206058,1909,11.1,1787,10.4,31388,11281,20107,5.5,15.2,29457,9191,20266,4.5,14.3,1931,0.9,28.6,0,1194,1200,6082
1992,51,105888,135896,2238762,2231246,17108,12.7,14831,11,374562,141375,233187,6.3,16.8,359531,125861,233670,5.6,16.1,15031,0.7,32.2,0,8976,9204,63014
1992,53,101600,122720,1788958,1762116,18258,15.1,13309,11,352778,119603,233175,6.8,20,299095,109531,189564,6.2,17,53683,3,34,0,8465,8560,51128
1992,54,28504,34761,480578,481633,3833,11.1,3384,9.8,72880,25345,47535,5.3,15.1,74990,26896,48094,5.6,15.6,-2110,-0.5,30.2,0,2105,2125,12377
1992,55,93122,113187,1972054,1956277,11940,10.6,10146,9,273535,86757,186778,4.4,14,241981,79403,162578,4.1,12.4,31554,1.6,24.8,0,6408,6482,38974
1992,56,11550,13375,137228,136044,1694,12.8,1303,9.8,24804,8480,16324,6.2,18.2,22436,7421,15015,5.5,16.5,2368,1.7,33,0,758,765,4372
1993,1,65469,81747,1403361,1383614,9502,11.7,7846,9.7,218430,65268,153162,4.7,15.8,178936,61198,117738,4.4,12.9,39494,2.9,25.8,0,5347,5364,31041
1993,2,11182,13474,167070,165602,1729,12.9,1450,10.9,31561,9355,22206,5.6,19.1,28624,9127,19497,5.5,17.3,2937,1.8,34.6,0,840,848,4586
1993,4,65114,80526,1298091,1274470,11194,14,9285,11.7,249645,90817,158828,7.1,19.6,202402,78279,124123,6.1,15.9,47243,3.7,31.8,0,5990,6031,37420
1993,5,42502,50741,811676,796757,6190,12.3,4884,9.7,130566,42190,88376,5.3,16.4,100727,35773,64954,4.5,12.6,29839,3.8,25.2,0,3447,3491,18982
1993,6,523621,645854,10523744,10544319,75691,11.6,82404,12.7,1910742,667214,1243528,6.3,18.1,1951893,717702,1234191,6.8,18.5,-41151,-0.4,36.2,0,53373,54134,337484
1993,8,77950,92720,1376864,1344932,13199,14.5,9504,10.4,257304,87326,169978,6.5,19.1,193439,73116,120323,5.4,14.4,63865,4.7,28.8,0,6095,6129,35698
1993,9,67541,79579,1400971,1402935,7796,9.8,7695,9.7,206408,59618,146790,4.2,14.7,210335,60148,150187,4.3,15,-3927,-0.3,29.4,0,5024,5056,29112
1993,10,14343,17106,303236,302215,2030,11.9,1745,10.3,47202,16210,30992,5.4,15.6,45161,15455,29706,5.1,14.9,2041,0.7,29.8,0,1047,1049,6560
1993,11,14595,17502,428553,416194,1622,9.2,1813,10.3,78250,16182,62068,3.9,18.8,53533,18062,35471,4.3,12.9,24717,5.9,25.8,0,927,931,6106
1993,12,272304,332494,4737522,4649058,48609,14.8,40028,12.2,963067,373230,589837,8,20.7,786139,313297,472842,6.7,16.9,176928,3.8,33.8,0,27788,28115,175164
1993,13,117129,147615,2579791,2541555,19251,13.2,15280,10.5,450642,163255,287387,6.4,17.7,374171,135772,238399,5.3,14.7,76471,3,29.4,0,9959,10007,66248
1993,15,21470,27075,431251,438691,2827,10.4,2806,10.3,59317,21741,37576,5,13.5,74196,22086,52110,5,16.9,-14879,-3.4,27,0,1840,1848,10282
1993,16,21916,25827,334617,329685,3435,13.5,2536,10,59152,20869,38283,6.3,17.9,49287,16387,32900,5,14.9,9865,3,29.8,0,1646,1648,9373
1993,17,206519,251173,4626298,4618814,26494,10.6,22985,9.2,696047,233853,462194,5.1,15.1,681080,205320,475760,4.4,14.7,14967,0.4,29.4,0,14789,14897,89873
1993,18,96920,121517,2207126,2180622,12614,10.5,10506,8.7,324265,94108,230157,4.3,14.9,271257,86991,184266,4,12.4,53008,2.5,24.8,0,7091,7137,43303
1993,19,55982,68841,1045910,1036294,6297,9.2,5642,8.2,138010,41020,96990,4,13.3,118779,35806,82973,3.5,11.5,19231,1.8,23,0,3768,3787,19290
1993,20,50345,61099,897112,891889,6480,10.7,5633,9.3,129309,41944,87365,4.7,14.5,118862,39516,79346,4.4,13.3,10447,1.2,26.6,0,3724,3755,21946
1993,21,60207,74028,1240565,1219791,8352,11.4,7203,9.8,196921,67487,129434,5.5,16.1,155373,56191,99182,4.6,12.7,41548,3.4,25.4,0,4867,4891,28076
1993,22,67378,83479,1308319,1301719,9098,11,7743,9.3,221016,73592,147424,5.7,17,207818,67483,140335,5.2,16,13198,1,32,0,5240,5264,38053
1993,23,25268,29698,403857,395487,3257,11,2906,9.8,65670,23138,42532,5.9,16.6,48929,17936,30993,4.5,12.4,16741,4.2,24.8,0,1923,1946,9519
1993,24,84326,103881,1706883,1708420,11922,11.5,10941,10.6,269314,94928,174386,5.6,15.8,272387,91198,181189,5.3,15.9,-3073,-0.1,31.6,0,6522,6583,45729
1993,25,113352,137012,2589055,2566101,13736,10,13087,9.6,401019,124820,276199,4.9,15.6,355112,116717,238395,4.5,13.8,45907,1.8,27.6,0,8417,8531,51333
1993,26,154698,191412,3400548,3362974,19553,10.3,17233,9,508333,155446,352887,4.6,15.1,433186,135062,298124,4,12.9,75147,2.2,25.8,0,11281,11365,67732
1993,27,86404,105058,1906105,1875312,11405,11,8748,8.4,291803,98871,192932,5.3,15.6,230217,75775,154442,4,12.3,61586,3.3,24.6,0,5631,5697,36391
1993,28,40454,49495,768804,754403,5870,12,4765,9.7,127054,45824,81230,6.1,16.8,98252,38029,60223,5,13,28802,3.8,26,0,3411,3419,20647
1993,29,98327,120353,2006735,1999797,13536,11.3,11706,9.8,294388,96109,198279,4.8,14.7,280513,96940,183573,4.8,14,13875,0.7,28,0,7886,7954,49509
1993,30,20281,23509,242247,238303,2821,12.1,2322,10,42960,15877,27083,6.7,18,35072,11848,23224,5,14.7,7888,3.3,29.4,0,1588,1598,8014
1993,31,34368,41185,613664,606642,4070,9.9,3572,8.7,87083,26733,60350,4.4,14.4,73041,21578,51463,3.6,12,14042,2.4,24,0,2400,2411,12008
1993,32,24180,28778,568789,557058,4394,15.5,3533,12.4,101543,40328,61215,7.2,18.2,78080,29624,48456,5.3,14,23463,4.2,28,0,2289,2322,17443
1993,33,24411,28756,419975,416390,3251,11.3,3008,10.5,64362,21629,42733,5.2,15.5,57192,19890,37302,4.8,13.7,7170,1.8,27.4,0,1977,1985,9354
1993,34,159560,186062,3058973,3051208,20539,11.1,18031,9.7,494448,155148,339300,5.1,16.2,478919,149461,329458,4.9,15.7,15529,0.5,31.4,0,11986,12032,64492
1993,35,28465,33907,450920,443261,4261,12.7,3399,10.2,83109,29017,54092,6.5,18.7,67791,23345,44446,5.3,15.3,15318,3.4,30.6,0,2259,2262,11836
1993,36,346135,403463,6588161,6619001,44526,11,43532,10.8,1005627,338239,667388,5.1,15.2,1067308,321039,746269,4.9,16.1,-61681,-0.9,30.4,0,30412,30604,165144
1993,37,121417,152818,2701040,2664872,16727,11,14102,9.3,407628,126316,281312,4.7,15.3,335291,110687,224604,4.2,12.6,72337,2.7,25.2,0,9471,9543,56372
1993,38,14811,17521,212000,208498,1726,9.9,1447,8.3,30431,9928,20503,4.8,14.6,23427,7700,15727,3.7,11.2,7004,3.4,22.4,0,977,979,4539
1993,39,179327,228921,4246355,4203837,22110,9.7,20571,9,628348,190754,437594,4.5,14.9,543312,181422,361890,4.3,12.9,85036,2,25.8,0,12663,12793,77451
1993,40,57941,70099,976520,964766,8108,11.7,6945,10,159464,56528,102936,5.9,16.5,135955,48379,87576,5,14.1,23509,2.4,28.2,0,4659,4681,24837
1993,41,63699,75902,1055836,1040300,9466,12.6,7830,10.4,182665,61052,121613,5.9,17.6,151592,52100,99492,5,14.6,31073,3,29.2,0,5061,5089,25567
1993,42,204609,253132,4501219,4489242,22895,9,22827,9,621938,199305,422633,4.4,13.9,597984,186493,411491,4.2,13.3,23954,0.6,26.6,0,15050,15167,91796
1993,44,21056,23685,372368,367716,2574,10.9,2234,9.5,57464,21952,35512,6,15.6,48160,17028,31132,4.6,13.1,9304,2.5,26.2,0,1464,1469,7917
1993,45,59902,74793,1276352,1264687,8775,11.8,7292,9.8,186598,63624,122974,5,14.8,163268,55670,107598,4.4,12.9,23330,1.9,25.8,0,4889,4913,25575
1993,46,16522,19167,244463,239301,2047,10.8,1670,8.8,39393,14328,25065,6,16.5,29068,10730,18338,4.5,12.1,10325,4.4,24.2,0,1116,1126,5553
1993,47,84755,106592,1945924,1919168,12462,11.8,10143,9.6,315666,103438,212228,5.4,16.4,262153,85163,176990,4.4,13.7,53513,2.7,27.4,0,6708,6790,42839
1993,48,290647,371928,6184588,6088341,47730,12.9,40624,11,1200051,411655,788396,6.8,19.7,1007556,374325,633231,6.1,16.5,192495,3.2,33,0,26207,26455,182304
1993,49,29452,35556,648471,630566,4951,14.2,3618,10.4,117164,38835,78329,6.2,18.6,81353,33772,47581,5.4,12.9,35811,5.7,25.8,0,2384,2398,18134
1993,50,15467,17490,213801,210763,1931,11.1,1661,9.6,31283,10142,21141,4.8,14.8,25207,9503,15704,4.5,12,6076,2.8,24,0,1144,1146,5410
1993,51,108317,137974,2384358,2310402,15722,11.5,13300,9.7,467131,127324,339807,5.5,20.2,319219,104269,214950,4.5,13.8,147912,6.4,27.6,0,8408,8463,48063
1993,53,104705,125596,1830827,1818453,16688,13.4,13257,10.7,304776,106316,198460,5.8,16.8,280029,96669,183360,5.3,15.4,24747,1.4,30.8,0,8623,8692,48849
1993,54,28814,35016,487005,483575,3491,10,3145,9,71133,20940,50193,4.3,14.7,64272,21348,42924,4.4,13.3,6861,1.4,26.6,0,2091,2107,11248
1993,55,95081,115190,2027665,1999828,11819,10.4,9539,8.4,287401,88488,198913,4.4,14.4,231728,77964,153764,3.9,11.6,55673,2.8,23.2,0,6423,6500,39162
1993,56,11893,13848,140982,139467,1859,13.7,1344,9.9,25548,10624,14924,7.6,18.3,22518,7667,14851,5.5,16.1,3030,2.2,32.2,0,878,887,4696
1994,1,67286,83845,1431344,1415686,10433,12.6,8084,9.8,221993,84519,137474,6,15.7,190676,63998,126678,4.5,13.5,31317,2.2,27,0,5494,5520,36093
1994,2,11508,13793,171419,169156,1815,13.3,1437,10.5,34021,12757,21264,7.5,20.1,29495,9253,20242,5.5,17.4,4526,2.7,34.8,0,842,848,3909
1994,4,67689,83742,1385844,1341062,12633,15.4,9129,11.1,291770,113189,178581,8.4,21.8,202206,77931,124275,5.8,15.1,89564,6.7,30.2,0,6188,6207,39114
1994,5,43581,52126,831542,820806,6638,12.9,5063,9.8,134019,52300,81719,6.4,16.3,112546,44655,67891,5.4,13.7,21473,2.6,27.4,0,3621,3633,23836
1994,6,522542,643878,10460782,10482536,80510,12.5,79138,12.3,1803620,701909,1101711,6.7,17.2,1847128,685579,1161549,6.5,17.6,-43508,-0.4,34.4,0,51126,51531,361183
1994,8,81837,97296,1433795,1404568,14768,15.5,9892,10.4,266837,103941,162896,7.4,19,208383,80068,128315,5.7,14.8,58454,4.2,29.6,0,6647,6675,39236
1994,9,67791,79937,1378416,1387373,8135,10.2,7555,9.5,191215,61124,130091,4.4,13.8,209129,69068,140061,5,15.1,-17914,-1.3,27.6,0,4995,5018,37974
1994,10,14716,17595,329144,316236,2205,12.7,1671,9.6,71328,17358,53970,5.5,22.6,45511,11923,33588,3.8,14.4,25817,8.2,28.8,0,1022,1022,5436
1994,11,14721,17678,409448,420402,1788,10.2,1568,8.9,53769,19538,34231,4.6,12.8,75677,14746,60931,3.5,18,-21908,-5.2,25.6,0,903,924,5120
1994,12,278435,340126,4921614,4824000,49460,14.7,40658,12.1,954796,371543,583253,7.7,19.8,759569,289189,470380,6,15.7,195227,4.1,31.4,0,28968,29123,176386
1994,13,120520,151835,2684582,2627284,20720,13.8,16083,10.7,478190,183323,294867,7,18.2,363595,141045,222550,5.4,13.8,114595,4.4,27.6,0,10631,10687,66580
1994,15,21498,27090,422313,426562,2803,10.4,2678,9.9,60706,26368,34338,6.2,14.2,69203,25379,43824,5.9,16.2,-8497,-2,28.4,0,1746,1780,13709
1994,16,23171,27213,356354,345144,4065,15.3,2543,9.6,68705,25613,43092,7.4,19.9,46284,16994,29290,4.9,13.4,22421,6.5,26.8,0,1705,1716,9796
1994,17,209809,255351,4736572,4678668,27724,10.9,22832,9,712526,244495,468031,5.2,15.2,596719,197350,399369,4.2,12.8,115807,2.4,25.6,0,14937,14989,96058
1994,18,98943,124049,2260036,2233701,13506,11,10697,8.7,334910,111830,223080,5,15,282239,97641,184598,4.4,12.6,52671,2.4,25.2,0,7148,7194,41713
1994,19,56639,69739,1069040,1056476,6958,10,5796,8.4,150183,48669,101514,4.6,14.2,125055,44516,80539,4.2,11.8,25128,2.4,23.6,0,3882,3896,20345
1994,20,51342,62265,926505,911574,7126,11.6,5798,9.4,143739,51411,92328,5.6,15.8,113877,40339,73538,4.4,12.5,29862,3.3,25,0,3879,3924,21588
1994,21,61225,75362,1273897,1256774,8609,11.5,7056,9.4,197148,71617,125531,5.7,15.7,162902,53996,108906,4.3,13,34246,2.7,26,0,4850,4864,30486
1994,22,68781,85183,1343308,1324505,10030,11.9,8077,9.6,225916,83311,142605,6.3,17.1,188311,61113,127198,4.6,14.2,37605,2.9,28.4,0,5426,5456,34472
1994,23,25607,30138,408923,405806,3467,11.6,2888,9.7,62887,21658,41229,5.3,15.5,56653,19460,37193,4.8,14,6234,1.5,28,0,2004,2008,11391
1994,24,85674,105422,1727812,1716046,12282,11.7,10459,10,283458,100226,183232,5.8,16.5,259928,88766,171162,5.2,15.1,23530,1.4,30.2,0,6511,6582,40204
1994,25,115037,139001,2613232,2600003,14999,10.9,12688,9.2,391832,125317,266515,4.8,15.1,365373,117615,247758,4.5,14.1,26459,1,28.2,0,8198,8232,57016
1994,26,157502,194921,3489252,3445790,20752,10.7,16793,8.7,533068,180240,352828,5.2,15.5,446144,163368,282776,4.7,12.9,86924,2.6,25.8,0,11192,11313,73844
1994,27,88732,107942,1956865,1930112,12132,11.4,8965,8.4,285453,94414,191039,4.9,14.8,231949,79720,152229,4.1,12,53504,2.8,24,0,5864,5890,39890
1994,28,41036,50161,815888,791328,6012,12.1,5180,10.4,148640,61979,86661,7.8,18.8,99519,36880,62639,4.7,12.6,49121,6.2,25.2,0,3692,3708,19494
1994,29,100328,122846,2064967,2035731,14992,12.3,12121,10,319567,110230,209337,5.4,15.7,261096,92122,168974,4.5,12.8,58471,2.9,25.6,0,8297,8326,49106
1994,30,20910,24208,245770,244324,3096,13,2303,9.7,39766,15091,24675,6.2,16.3,36874,12700,24174,5.2,15.1,2892,1.2,30.2,0,1618,1618,7495
1994,31,34865,41860,630042,621304,4417,10.6,3589,8.6,91899,33091,58808,5.3,14.8,74424,28004,46420,4.5,12,17475,2.8,24,0,2423,2431,13549
1994,32,25541,30306,619520,593960,5001,16.9,3371,11.4,131973,46783,85190,7.9,22.2,80852,34184,46668,5.8,13.6,51121,8.6,27.2,0,2299,2305,22045
1994,33,24938,29386,438034,428729,3643,12.5,2897,10,71939,24100,47839,5.6,16.8,53329,19803,33526,4.6,12.4,18610,4.4,24.8,0,1922,1923,9644
1994,34,161153,188149,3063643,3059740,21340,11.4,18733,10,465985,166432,299553,5.4,15.2,458180,158562,299618,5.2,15,7805,0.2,30,0,12261,12342,77361
1994,35,29296,34959,471013,460487,4769,13.9,3588,10.4,89392,34617,54775,7.5,19.4,68341,26003,42338,5.6,14.8,21051,4.6,29.6,0,2490,2498,14219
1994,36,346182,404583,6572940,6577196,45901,11.4,43653,10.8,961147,337456,623691,5.1,14.6,969660,319732,649928,4.9,14.7,-8513,-0.1,29.2,0,30413,30578,176318
1994,37,124703,156962,2808664,2753458,18570,12,13919,9,435635,156266,279369,5.7,15.8,325223,110904,214319,4,11.8,110412,4,23.6,0,9471,9515,58548
1994,38,15088,17823,217994,214874,1783,10.1,1456,8.2,30695,9413,21282,4.4,14.3,24457,7533,16924,3.5,11.4,6238,2.9,22.8,0,982,984,4384
1994,39,182187,232837,4323033,4271033,24183,10.5,19768,8.6,639737,222543,417194,5.2,15,535737,171776,363961,4,12.5,104000,2.5,25,0,12679,12811,77510
1994,40,59198,71605,995983,985686,8700,12.3,6940,9.8,159079,58294,100785,5.9,16.1,138484,47944,90540,4.9,14,20595,2.1,28,0,4910,4915,27242
1994,41,66366,79091,1108430,1081475,11066,14.3,7627,9.8,197936,74906,123030,6.9,18.3,144025,51437,92588,4.8,13.3,53911,5,26.6,0,5074,5087,26391
1994,42,204217,253732,4516306,4502812,23760,9.4,22368,8.8,627030,219753,407277,4.9,13.9,600042,206844,393198,4.6,13.3,26988,0.6,26.6,0,14892,15004,100242
1994,44,21339,23941,366229,369506,2670,11.2,2386,10,53520,22024,31496,6,14.5,60074,19638,40436,5.3,16.3,-6554,-1.8,29,0,1601,1605,9608
1994,45,61019,76260,1318077,1295956,9212,12.2,7447,9.9,212368,83779,128589,6.5,16.4,168126,61375,106751,4.7,13,44242,3.4,26,0,5044,5061,32217
1994,46,16930,19681,252414,248152,2298,11.8,1696,8.7,40029,15409,24620,6.2,16.1,31504,11972,19532,4.8,12.7,8525,3.4,25.4,0,1176,1179,7285
1994,47,86650,109019,2006873,1975439,12982,12,10245,9.5,321456,121710,199746,6.2,16.3,258587,96143,162444,4.9,13.1,62869,3.2,26.2,0,6929,6965,45778
1994,48,298036,381110,6297666,6235494,50738,13.5,40237,10.7,1129650,434802,694848,7,18.1,1005307,348317,656990,5.6,16.1,124343,2,32.2,0,26930,27069,172736
1994,49,31027,37422,689299,668480,5767,15.8,3811,10.4,127965,47138,80827,7.1,19.1,86327,34372,51955,5.1,12.9,41638,6.2,25.8,0,2616,2625,19734
1994,50,15704,17747,217434,215479,1922,10.9,1589,9,30114,9909,20205,4.6,14,26203,9179,17024,4.3,12.2,3911,1.8,24.4,0,1084,1089,4973
1994,51,110874,140984,2341852,2362058,16539,11.9,13205,9.5,370321,133153,237168,5.6,15.7,410733,104316,306417,4.4,17.4,-40412,-1.7,31.4,0,8363,8402,46038
1994,53,107797,129143,1860869,1844310,17883,14,13696,10.8,310756,113792,196964,6.2,16.8,277638,88094,189544,4.8,15.1,33118,1.7,30.2,0,9131,9154,48132
1994,54,29437,35824,498515,492503,3867,10.9,2963,8.4,76500,27498,49002,5.6,15.5,64476,21070,43406,4.3,13.1,12024,2.4,26.2,0,1983,1988,10467
1994,55,96519,117111,2076317,2050744,12009,10.3,9710,8.4,277454,94266,183188,4.6,13.5,226308,69433,156875,3.4,11,51146,2.5,22,0,6568,6606,38193
1994,56,12381,14388,147312,144000,1864,13.2,1266,9,27002,10774,16228,7.5,18.8,20377,6724,13653,4.7,14.2,6625,4.6,28.4,0,850,852,4113
1995,1,69048,85992,1505050,1467161,10624,12.5,8148,9.6,250494,86095,164399,5.9,17.1,174716,59857,114859,4.1,11.9,75778,5.2,23.8,0,5666,5709,33577
1995,2,11844,14141,174314,172622,1883,13.5,1470,10.5,31121,11717,19404,6.8,18,27737,8836,18901,5.1,16.1,3384,1.9,32.2,0,943,952,4957
1995,4,70141,86602,1477924,1431397,12919,15.2,9549,11.2,293627,113276,180351,7.9,20.5,200573,74115,126458,5.2,14,93054,6.5,28,0,6442,6546,41526
1995,5,44677,53540,875122,852891,6906,13.1,5276,10,146672,50418,96254,5.9,17.2,102211,41968,60243,4.9,12,44461,5.2,24,0,3749,3754,23373
1995,6,526630,648819,10772608,10612696,82407,12.8,73830,11.4,1883883,670222,1213661,6.3,17.8,1564058,562375,1001683,5.3,14.7,319825,3.1,29.4,0,48919,49331,296119
1995,8,85481,101601,1524431,1479079,15221,15.3,10464,10.5,300081,120867,179214,8.2,20.3,209376,74248,135128,5,14.2,90705,6.1,28.4,0,6969,6991,42739
1995,9,68732,80991,1393860,1384583,8631,10.7,7359,9.1,197600,73710,123890,5.3,14.3,179045,56978,122067,4.1,12.9,18555,1.4,25.8,0,4785,4840,25888
1995,10,15188,18140,323189,314015,2314,13,1726,9.7,56073,17457,38616,5.6,17.9,37724,13259,24465,4.2,12,18349,5.9,24,0,1087,1092,6034
1995,11,14766,17786,409180,409209,1807,10.2,1659,9.4,56717,17637,39080,4.3,13.9,56776,17589,39187,4.3,13.9,-59,0,27.8,0,923,929,7438
1995,12,283823,346996,5126170,5016328,49701,14.5,41248,12,1007948,418066,589882,8.3,20.1,788264,308306,479958,6.1,15.7,219684,4.4,31.4,0,29310,29472,180439
1995,13,124519,157074,2856292,2770105,21795,14.1,15927,10.3,537140,211039,326101,7.6,19.4,364767,140419,224348,5.1,13.2,172373,6.2,26.4,0,10541,10594,71709
1995,15,21541,27175,421984,421520,2844,10.5,2640,9.7,57269,24832,32437,5.9,13.6,56341,18843,37498,4.5,13.4,928,0.2,26.8,0,1787,1796,8445
1995,16,24065,28187,368115,361735,4008,14.5,2868,10.4,64987,24374,40613,6.7,18,52227,21664,30563,6,14.4,12760,3.6,28.8,0,1937,1942,9125
1995,17,213352,259939,4872729,4802905,28931,11.2,23352,9.1,743754,255434,488320,5.3,15.5,604107,198105,406002,4.1,12.6,139647,2.9,25.2,0,15029,15116,97450
1995,18,100811,126878,2362250,2310761,14429,11.5,11156,8.9,366674,127044,239630,5.5,15.9,263695,85142,178553,3.7,11.4,102979,4.5,22.8,0,7494,7526,43496
1995,19,57219,70597,1108613,1088302,7155,10.2,6008,8.6,160363,54241,106122,5,14.7,119741,43528,76213,4,11,40622,3.7,22,0,4049,4063,20822
1995,20,52116,63276,955908,940484,7148,11.4,5822,9.3,139911,51015,88896,5.4,14.9,109062,37958,71104,4,11.6,30849,3.3,23.2,0,3989,4012,20664
1995,21,62300,76856,1328099,1300388,8922,11.7,7094,9.3,214043,77111,136932,5.9,16.5,158621,58016,100605,4.5,12.2,55422,4.3,24.4,0,4882,4902,30137
1995,22,69886,86550,1386454,1363447,9883,11.5,8174,9.5,243455,92228,151227,6.8,17.9,197440,76146,121294,5.6,14.5,46015,3.4,29,0,5487,5541,38903
1995,23,26173,30698,420050,414308,3653,12,2987,9.8,62510,21162,41348,5.1,15.1,51025,17123,33902,4.1,12.3,11485,2.8,24.6,0,2011,2016,9923
1995,24,87609,107670,1799854,1762549,13082,12.3,10487,9.8,300268,105634,194634,6,17,225658,81999,143659,4.7,12.8,74610,4.2,25.6,0,6764,6810,40783
1995,25,117400,141877,2688277,2650018,16074,11.4,12863,9.2,407820,136386,271434,5.1,15.4,331303,112102,219201,4.2,12.5,76517,2.9,25,0,8210,8285,54848
1995,26,161185,199372,3655259,3570768,22286,11.3,17163,8.7,596694,208412,388282,5.8,16.7,427712,145061,282651,4.1,12,168982,4.7,24,0,11366,11418,72581
1995,27,90509,110034,2046314,1999955,12194,11.2,9512,8.7,313789,119346,194443,6,15.7,221072,74398,146674,3.7,11.1,92717,4.6,22.2,0,6074,6114,40182
1995,28,41788,51166,848730,831977,6239,12.3,5021,9.9,145722,59166,86556,7.1,17.5,112217,40174,72043,4.8,13.5,33505,4,27,0,3521,3528,22712
1995,29,102010,124999,2136686,2099661,15030,12.1,12291,9.9,341691,117953,223738,5.6,16.3,267640,93507,174133,4.5,12.7,74051,3.6,25.4,0,8403,8443,47187
1995,30,21520,24934,266569,255803,3339,13.6,2412,9.8,53714,27871,25843,10.9,21,32182,12777,19405,5,12.6,21532,8.4,25.2,0,1728,1731,8476
1995,31,35176,42348,657560,643305,4297,10.2,3567,8.5,97246,31883,65363,5,15.1,68736,23982,44754,3.7,10.7,28510,4.4,21.4,0,2447,2457,12230
1995,32,26892,31929,662234,640361,5407,17.4,3629,11.7,125405,53863,71542,8.4,19.6,81659,29032,52627,4.5,12.8,43746,6.8,25.6,0,2522,2527,17874
1995,33,25732,30310,459693,448730,3837,12.9,2859,9.6,75860,30460,45400,6.8,16.9,53933,20173,33760,4.5,12,21927,4.9,24,0,1901,1907,10675
1995,34,165160,192462,3138899,3100470,23219,12.2,18334,9.6,487946,171815,316131,5.5,15.7,411087,146018,265069,4.7,13.3,76859,2.4,26.6,0,12241,12343,70503
1995,35,29946,35751,491698,480590,4821,13.6,3798,10.7,89016,34529,54487,7.2,18.5,66799,26682,40117,5.6,13.9,22217,4.6,27.8,0,2606,2618,14338
1995,36,350275,409296,6664427,6618507,47695,11.7,41862,10.3,998714,356178,642536,5.4,15.1,906874,292884,613990,4.4,13.7,91840,1.4,27.4,0,29266,29382,160468
1995,37,128837,161944,2942967,2876605,19733,12.4,14283,9,455829,158905,296924,5.5,15.8,323105,110176,212929,3.8,11.2,132724,4.6,22.4,0,9691,9721,56785
1995,38,15283,18039,226805,221919,1764,9.9,1415,7.9,34354,11282,23072,5.1,15.5,24582,8827,15755,4,11.1,9772,4.4,22.2,0,943,949,4808
1995,39,185525,237011,4485693,4401712,24982,10.6,20071,8.5,668623,226016,442607,5.1,15.2,500661,162502,338159,3.7,11.4,167962,3.8,22.8,0,12881,12984,79272
1995,40,59903,72538,1022543,1008609,8597,11.9,7307,10.1,164030,59534,104496,5.9,16.3,136162,51488,84674,5.1,13.5,27868,2.8,27,0,5178,5195,27144
1995,41,68451,81352,1161490,1132900,11197,14,8516,10.6,207497,76876,130621,6.8,18.3,150316,54018,96298,4.8,13.3,57181,5,26.6,0,5657,5719,30658
1995,42,206941,257160,4637473,4573282,25879,10.1,21538,8.4,654670,226063,428607,4.9,14.3,526288,182273,344015,4,11.5,128382,2.8,23,0,14148,14221,91506
1995,44,21550,24251,377059,371465,2667,11.1,2271,9.4,55390,19332,36058,5.2,14.9,44201,14200,30001,3.8,11.9,11189,3,23.8,0,1553,1561,7547
1995,45,62696,78317,1368948,1343091,9877,12.8,7568,9.8,216858,82386,134472,6.1,16.1,165146,60194,104952,4.5,12.3,51712,3.8,24.6,0,5150,5180,30337
1995,46,17214,20001,264742,258355,2151,10.9,1682,8.5,38938,12477,26461,4.8,15.1,26164,10345,15819,4,10.1,12774,5,20.2,0,1165,1166,5407
1995,47,88867,111889,2136510,2072561,13698,12.4,10494,9.5,371270,124405,246865,6,17.9,243372,82441,160931,4,11.7,127898,6.2,23.4,0,7094,7146,43373
1995,48,304396,389536,6599707,6441415,51825,13.5,41356,10.7,1242302,481310,760992,7.5,19.3,925719,336800,588919,5.2,14.4,316583,4.9,28.8,0,27761,28034,180881
1995,49,32481,39151,733108,710461,5947,15.5,4039,10.6,138805,54208,84597,7.6,19.5,93511,33873,59638,4.8,13.2,45294,6.3,26.4,0,2765,2779,20257
1995,50,15922,17985,221759,219446,1937,10.8,1615,9,32684,10765,21919,4.9,14.9,28057,11601,16456,5.3,12.8,4627,2.1,25.6,0,1139,1140,6263
1995,51,113884,144511,2427675,2381879,17559,12.3,13557,9.5,393044,142830,250214,6,16.5,301451,107899,193552,4.5,12.7,91593,3.8,25.4,0,8717,8762,49895
1995,53,109840,131637,1913170,1886220,18061,13.9,14723,11.3,321284,124153,197131,6.6,17,267383,98175,169208,5.2,14.2,53901,2.8,28.4,0,9943,10024,56534
1995,54,30057,36574,517833,508010,4153,11.5,3262,9,82392,29071,53321,5.7,16.2,62745,24274,38471,4.8,12.4,19647,3.8,24.8,0,2164,2167,11033
1995,55,97848,118846,2151101,2112583,12283,10.4,10008,8.5,293148,94342,198806,4.5,13.9,216113,70305,145808,3.3,10.2,77035,3.7,20.4,0,6770,6880,39622
1995,56,12698,14699,152540,150158,1802,12.4,1402,9.6,26271,10203,16068,6.8,17.5,21506,7862,13644,5.2,14.3,4765,3.2,28.6,0,955,956,4198
1996,1,70313,87757,1530687,1518415,10748,12.4,8784,10.1,239297,90450,148847,6,15.8,214753,72059,142694,4.7,14.1,24544,1.7,28.2,0,6122,6122,37109
1996,2,12126,14442,177145,175604,1860,13,1514,10.6,30353,9710,20643,5.5,17.3,27270,10846,16424,6.2,15.5,3083,1.8,31,0,932,932,4457
1996,4,72366,89512,1560080,1518199,13182,15,10013,11.4,296492,115548,180944,7.6,19.5,212731,79948,132783,5.3,14,83761,5.5,28,0,6656,6657,43109
1996,5,45348,54375,891144,882720,6716,12.5,5674,10.5,131894,47046,84848,5.3,14.9,115047,37364,77683,4.2,13,16847,1.9,26,0,4012,4013,21739
1996,6,534053,656259,10961827,10872745,83442,12.8,73557,11.3,1941619,688161,1253458,6.3,17.9,1763455,672108,1091347,6.2,16.2,178164,1.7,32.4,0,48290,48302,308874
1996,8,88204,104559,1572732,1548643,15069,14.6,11749,11.4,305770,129749,176021,8.4,19.7,257592,103194,154398,6.7,16.6,48178,3.1,33.2,0,7657,7658,44784
1996,9,69032,81391,1412955,1404439,8158,10.1,7617,9.4,204659,81515,123144,5.8,14.6,187626,61236,126390,4.4,13.4,17033,1.2,26.8,0,4854,4855,28906
1996,10,15577,18539,323905,323569,2218,12.1,1850,10.1,48465,18393,30072,5.7,15,47793,17089,30704,5.3,14.8,672,0.2,29.6,0,1118,1118,6933
1996,11,14906,17890,389976,399349,1841,10.3,1690,9.5,48389,16404,31985,4.1,12.1,67135,16817,50318,4.2,16.8,-18746,-4.7,24.2,0,944,944,5785
1996,12,289030,353025,5271478,5196417,49383,14.1,42179,12.1,1026371,426001,600370,8.2,19.8,876249,341184,535065,6.6,16.9,150122,2.9,33.8,0,29248,29250,186886
1996,13,128362,161653,2949126,2903747,22441,14.1,17518,11,535277,209338,325939,7.2,18.4,444518,175095,269423,6,15.3,90759,3.1,30.6,0,11278,11279,76228
1996,15,21497,27056,421850,422405,2800,10.3,2831,10.4,60606,27059,33547,6.4,14.3,61715,20520,41195,4.9,14.6,-1109,-0.3,28.6,0,1781,1781,9079
1996,16,24830,29090,378675,373022,4180,14.6,3090,10.8,70012,26970,43042,7.2,18.8,58705,21956,36749,5.9,15.7,11307,3.1,31.4,0,2127,2127,12484
1996,17,216094,263357,4931340,4902850,28929,11.1,25076,9.6,728025,262900,465125,5.4,14.8,671044,206355,464689,4.2,13.7,56981,1.1,27.4,0,15954,15955,93478
1996,18,102127,128406,2381802,2376648,14063,11,12312,9.6,345271,127492,217779,5.4,14.5,334963,117987,216976,5,14.1,10308,0.4,28.2,0,7966,7967,49013
1996,19,57810,71263,1140527,1124860,6921,9.8,6100,8.6,159045,58785,100260,5.2,14.1,127710,40744,86966,3.6,11.4,31335,2.7,22.8,0,4029,4030,21048
1996,20,52847,64212,987252,972457,7216,11.3,6105,9.6,152228,57504,94724,5.9,15.7,122637,44847,77790,4.6,12.6,29591,3.1,25.2,0,4167,4167,24409
1996,21,62979,78026,1359124,1344852,8837,11.4,7542,9.7,215921,84632,131289,6.3,16.1,187377,61319,126058,4.6,13.9,28544,2.2,27.8,0,5153,5153,31829
1996,22,71326,88249,1427583,1407582,9811,11.2,7876,9,233911,81048,152863,5.8,16.6,193909,63194,130715,4.5,13.8,40002,2.8,27.6,0,5345,5346,33648
1996,23,26749,31344,425449,423091,3802,12.3,3038,9.8,60090,23893,36197,5.6,14.2,55374,18874,36500,4.5,13.1,4716,1.1,26.2,0,2126,2126,10898
1996,24,88576,108683,1803330,1801277,12369,11.4,11090,10.3,283112,108628,174484,6,15.7,279005,96142,182863,5.3,15.5,4107,0.2,31,0,7008,7013,43989
1996,25,119067,143746,2724484,2706904,15280,10.7,13193,9.2,393810,130038,263772,4.8,14.5,358649,135500,223149,5,13.2,35161,1.3,26.4,0,8335,8336,57712
1996,26,164362,203331,3695771,3676556,22126,11,17854,8.9,531113,183711,347402,5,14.4,492683,149250,343433,4.1,13.4,38430,1,26.8,0,11838,11838,76680
1996,27,92982,112672,2090838,2070879,12548,11.3,9799,8.8,300977,109198,191779,5.3,14.5,261059,78893,182166,3.8,12.6,39918,1.9,25.2,0,6274,6276,41810
1996,28,42289,51935,858614,853618,6298,12.2,5362,10.4,134769,56534,78235,6.6,15.8,124776,44882,79894,5.3,14.6,9993,1.2,29.2,0,3707,3707,22073
1996,29,103305,126822,2178066,2158432,14512,11.5,12462,9.9,334076,122038,212038,5.7,15.5,294809,99793,195016,4.6,13.7,39267,1.8,27.4,0,8563,8563,48797
1996,30,22106,25417,261846,264209,3300,13.1,2690,10.7,42492,17520,24972,6.6,16.1,47217,14285,32932,5.4,17.9,-4725,-1.8,32.2,0,1747,1747,8265
1996,31,35421,42667,683921,672756,4290,10.1,3848,9.1,98247,35507,62740,5.3,14.6,75916,24987,50929,3.7,11.3,22331,3.3,22.6,0,2618,2618,13617
1996,32,27930,33286,703891,682960,5578,17.1,4074,12.5,145914,66606,79308,9.8,21.4,104051,41638,62413,6.1,15.2,41863,6.2,30.4,0,2723,2723,20811
1996,33,26467,31131,478277,469079,3881,12.6,2982,9.7,75158,26124,49034,5.6,16,56761,20065,36696,4.3,12.1,18397,3.9,24.2,0,1939,1940,10861
1996,34,167572,195012,3163644,3152193,22757,11.7,19852,10.2,494793,183190,311603,5.8,15.7,471892,163397,308495,5.2,15,22901,0.7,30,0,13288,13291,71351
1996,35,30597,36604,504828,498466,4825,13.3,3814,10.5,88560,34933,53627,7,17.8,75836,27554,48282,5.5,15.2,12724,2.6,30.4,0,2602,2604,15999
1996,36,353252,412456,6687122,6674175,47835,11.6,43940,10.7,987027,374157,612870,5.6,14.8,961134,331783,629351,5,14.4,25893,0.4,28.8,0,30641,30644,175352
1996,37,132435,166249,2999542,2974143,20398,12.4,15592,9.5,452257,172087,280170,5.8,15.2,401460,134687,266773,4.5,13.5,50797,1.7,27,0,10145,10145,62089
1996,38,15474,18230,232298,229929,1734,9.6,1515,8.4,34787,13886,20901,6,15.1,30049,9609,20440,4.2,13.1,4738,2,26.2,0,999,999,4927
1996,39,187329,239529,4572976,4533312,24350,10.2,21552,9,668654,243556,425098,5.4,14.7,589326,188023,401303,4.1,13,79328,1.7,26,0,13673,13676,83428
1996,40,60654,73531,1059291,1041528,8723,11.9,7573,10.4,176645,73371,103274,7,17,141118,52233,88885,5,13.5,35527,3.5,27,0,5284,5287,28645
1996,41,70164,83638,1218202,1190629,11224,13.6,8664,10.5,215142,79107,136035,6.6,18.1,159996,56276,103720,4.7,13.4,55146,4.7,26.8,0,5879,5881,32477
1996,42,207845,258827,4685783,4666632,24941,9.7,22889,8.9,633482,233168,400314,5,13.6,595181,205294,389887,4.4,12.8,38301,0.8,25.6,0,15099,15101,98273
1996,44,21728,24468,378142,377702,2694,11.1,2430,10,50893,19108,31785,5.1,13.5,50012,18481,31531,4.9,13.2,881,0.3,26.4,0,1662,1664,9645
1996,45,64114,80151,1398334,1383957,10215,12.9,8055,10.2,216645,87696,128949,6.3,15.7,187891,62565,125326,4.5,13.6,28754,2.1,27.2,0,5429,5429,32535
1996,46,17492,20312,268800,266915,2236,11.1,1894,9.4,37721,15507,22214,5.8,14.1,33950,12372,21578,4.6,12.7,3771,1.4,25.4,0,1290,1290,6353
1996,47,90478,114388,2148564,2143454,14112,12.5,11363,10,329405,133200,196205,6.2,15.4,319185,122966,196219,5.7,14.9,10220,0.5,29.8,0,7669,7673,69901
1996,48,310858,397263,6823281,6715431,52251,13.3,43317,11,1250381,498556,751825,7.4,18.6,1034682,377712,656970,5.6,15.4,215699,3.2,30.8,0,28644,28647,186524
1996,49,34167,41051,770346,750970,6368,15.9,4356,10.9,140068,57990,82078,7.7,18.7,101316,35018,66298,4.7,13.5,38752,5.2,27,0,2996,2997,20015
1996,50,16054,18176,222794,222244,1952,10.8,1696,9.4,32502,12613,19889,5.7,14.6,31402,14939,16463,6.7,14.1,1100,0.5,28.2,0,1214,1214,6718
1996,51,115642,146703,2462999,2446462,17267,11.9,14850,10.2,386717,145956,240761,6,15.8,353643,119626,234017,4.9,14.5,33074,1.3,29,0,9340,9340,50264
1996,53,112059,134385,1948739,1932577,18642,14,15540,11.7,318100,125562,192538,6.5,16.5,285775,97948,187827,5.1,14.8,32325,1.7,29.6,0,10204,10207,55249
1996,54,30223,36896,520017,519670,3966,10.8,3524,9.6,76689,31778,44911,6.1,14.8,75995,24850,51145,4.8,14.6,694,0.2,29.2,0,2369,2369,11774
1996,55,99071,120445,2186126,2170132,12286,10.3,10504,8.8,279732,97589,182143,4.5,12.9,247744,79890,167854,3.7,11.4,31988,1.5,22.8,0,6947,6953,38541
1996,56,13019,15048,151062,151767,1904,12.8,1508,10.1,23463,9251,14212,6.1,15.5,24873,7612,17261,5,16.4,-1410,-0.9,31,0,1015,1015,4342
1997,1,71144,89446,1543872,1537136,11375,12.8,9718,11,261070,99207,161863,6.5,17,247599,88676,158923,5.8,16.1,13471,0.9,32.2,0,6368,6368,41803
1997,2,12386,14784,182100,179403,1992,13.6,1618,11.1,36536,12212,24324,6.8,20.4,31142,9728,21414,5.4,17.4,5394,3,34.8,0,971,971,4427
1997,4,74812,93249,1654877,1608900,15015,16.4,11421,12.5,371012,151317,219695,9.4,23.1,279058,118363,160695,7.4,17.3,91954,5.8,34.6,0,7067,7067,47515
1997,5,45669,55202,906826,897040,7028,12.8,6038,11,148373,55595,92778,6.2,16.5,128802,44163,84639,4.9,14.4,19571,2.1,28.8,0,4097,4097,22318
1997,6,541378,665191,11338461,11156365,90274,13.6,81053,12.3,2277081,824219,1452862,7.4,20.4,1912890,754029,1158861,6.8,17.1,364191,3.3,34.2,0,48594,48595,343041
1997,8,90861,108394,1629684,1601497,16715,15.7,12748,12,335394,141540,193854,8.8,20.9,279020,113152,165868,7.1,17.4,56374,3.5,34.8,0,7962,7962,50512
1997,9,69119,81947,1467221,1446106,8867,10.8,8321,10.2,247080,82717,164363,5.7,17.1,204850,76478,128372,5.3,14.2,42230,2.9,28.4,0,5022,5022,32804
1997,10,15974,19156,338014,330929,2595,13.7,2022,10.7,62027,24507,37520,7.4,18.7,47856,18798,29058,5.7,14.5,14171,4.2,29,0,1160,1160,7408
1997,11,14861,17813,391522,391072,1937,10.8,2029,11.4,57110,18969,38141,4.9,14.6,56209,22169,34040,5.7,14.4,901,0.2,28.8,0,1014,1014,6393
1997,12,292442,360038,5417465,5345198,53298,14.9,46034,12.9,1122567,467727,654840,8.8,21,978033,404553,573480,7.6,18.3,144534,2.7,36.6,0,30486,30487,199834
1997,13,131074,166159,3019982,2984554,23738,14.5,19081,11.6,584854,227696,357158,7.6,19.6,513998,199866,314132,6.7,17.2,70856,2.4,34.4,0,11976,11976,97208
1997,15,21465,27008,421114,421490,2923,10.8,2935,10.8,60876,20971,39905,5,14.4,61627,20553,41074,4.9,14.6,-751,-0.2,28.8,0,1763,1763,9599
1997,16,25591,30042,388612,384082,4548,15.4,3580,12.1,73648,29541,44107,7.7,19.2,64588,26398,38190,6.9,16.8,9060,2.4,33.6,0,2262,2262,11268
1997,17,217835,266395,5022914,4978115,30797,11.6,27535,10.4,807721,283160,524561,5.7,16.2,718123,261560,456563,5.3,14.4,89598,1.8,28.8,0,16580,16580,112785
1997,18,102825,130464,2432698,2408528,15371,11.9,13305,10.3,390576,136064,254512,5.6,16.2,342236,127441,214795,5.3,14.2,48340,2,28.4,0,8280,8280,54451
1997,19,58039,72006,1153221,1147735,7489,10.4,6705,9.4,173790,59895,113895,5.2,15.1,162819,57956,104863,5,14.2,10971,0.9,28.4,0,4158,4158,26815
1997,20,53376,65318,1023385,1005245,7975,12.3,6793,10.5,174505,68122,106383,6.8,17.4,138224,49374,88850,4.9,13.8,36281,3.6,27.6,0,4206,4206,24478
1997,21,63647,79389,1391601,1371672,9641,12.2,8244,10.5,237153,84400,152753,6.2,17.3,197295,72790,124505,5.3,14.4,39858,2.9,28.8,0,5162,5162,32675
1997,22,72236,89756,1461769,1446004,10572,11.9,9129,10.2,264222,93577,170645,6.5,18.3,232692,89193,143499,6.2,16.1,31530,2.2,32.2,0,5753,5753,36656
1997,23,27209,32018,435307,430662,3947,12.4,3284,10.4,67197,23503,43694,5.5,15.6,57906,22550,35356,5.2,13.4,9291,2.2,26.8,0,2075,2075,11602
1997,24,89539,110304,1868574,1836836,13889,12.7,12333,11.2,351030,131304,219726,7.1,19.1,287553,107709,179844,5.9,15.7,63477,3.4,31.4,0,7313,7313,43653
1997,25,121326,147110,2805946,2766247,17013,11.7,13728,9.4,465954,169209,296745,6.1,16.8,386556,136162,250394,4.9,14,79398,2.8,28,0,8292,8292,59456
1997,26,166347,206024,3788639,3743754,23485,11.5,20705,10.1,639487,217386,422101,5.8,17.1,549717,192681,357036,5.1,14.7,89770,2.4,29.4,0,12537,12537,80068
1997,27,94637,115306,2144436,2119426,13911,12.2,11272,9.9,344953,119021,225932,5.6,16.3,294933,114169,180764,5.4,13.9,50020,2.4,27.8,0,6753,6753,47824
1997,28,42823,52954,882866,872041,6611,12.6,5619,10.7,151326,53641,97685,6.2,17.4,129678,43868,85810,5,14.9,21648,2.5,29.8,0,3728,3728,20406
1997,29,103542,127680,2241041,2210582,15038,11.8,14132,11.1,371401,126462,244939,5.7,16.8,310483,114294,196189,5.2,14,60918,2.8,28,0,9119,9119,55989
1997,30,22641,26061,266325,264403,3470,13.5,2787,10.8,47129,18059,29070,6.8,17.8,43284,16647,26637,6.3,16.4,3845,1.4,32.8,0,1849,1849,9172
1997,31,35869,43250,689503,687057,4737,11,4107,9.6,106210,41529,64681,6,15.5,101317,32693,68624,4.8,14.7,4893,0.8,29.4,0,2555,2555,16265
1997,32,29497,35503,749991,727339,6644,19.3,4482,13,157371,67708,89663,9.3,21.6,112066,39295,72771,5.4,15.4,45305,6.2,30.8,0,2817,2817,18120
1997,33,26996,31818,489284,484063,3987,12.7,3311,10.5,79924,28032,51892,5.8,16.5,69482,25272,44210,5.2,14.4,10442,2.1,28.8,0,2070,2070,11713
1997,34,170256,198246,3258620,3211376,25191,12.8,21743,11,602191,212015,390176,6.6,18.8,507703,200176,307527,6.2,15.8,94488,3,31.6,0,13563,13563,80650
1997,35,30772,37202,512753,508848,5072,13.7,4435,12,95202,38017,57185,7.5,18.7,87391,29976,57415,5.9,17.2,7811,1.5,34.4,0,2835,2835,14981
1997,36,356988,417334,6803234,6750189,51064,12.3,46096,11.1,1130860,387493,743367,5.7,16.8,1024771,394211,630560,5.8,15.2,106089,1.6,30.4,0,30751,30751,177660
1997,37,136608,173211,3099523,3050876,24086,14.2,17074,10,524425,203777,320648,6.7,17.2,427131,156157,270974,5.1,14,97294,3.2,28,0,10584,10584,66155
1997,38,15289,18093,242742,237430,1784,9.8,1855,10.2,42820,13928,28892,5.9,18,32196,13595,18601,5.7,13.6,10624,4.4,27.2,0,1160,1160,7735
1997,39,188560,242041,4648851,4611578,27005,11.2,24440,10.1,752866,284970,467896,6.2,16.3,678320,238354,439966,5.2,14.7,74546,1.6,29.4,0,14418,14418,95599
1997,40,61333,74989,1096018,1077517,9820,13.2,8307,11.2,204461,79597,124864,7.4,19,167458,59614,107844,5.5,15.5,37003,3.5,31,0,5446,5446,33926
1997,41,71426,85569,1275105,1246957,11736,13.9,9702,11.5,246607,88780,157827,7.1,19.8,190311,72161,118150,5.8,15.3,56296,4.5,30.6,0,6122,6122,33249
1997,42,209412,262330,4768994,4732114,28317,10.9,24966,9.6,741724,258399,483325,5.5,15.7,667965,247491,420474,5.2,14.1,73759,1.6,28.2,0,15076,15076,110680
1997,44,21988,24755,388846,383661,2743,11.1,2450,9.9,60740,22062,38678,5.8,15.8,50370,17857,32513,4.7,13.1,10370,2.7,26.2,0,1663,1663,8942
1997,45,65661,82591,1437240,1418523,11184,13.7,8781,10.8,247138,97897,149241,6.9,17.4,209704,77775,131929,5.5,14.8,37434,2.6,29.6,0,5523,5523,36321
1997,46,17577,20566,276139,272416,2452,12,2122,10.4,44937,18296,26641,6.7,16.5,37491,14285,23206,5.2,13.8,7446,2.7,27.6,0,1354,1354,6876
1997,47,91617,116913,2207427,2179197,15107,13,12682,11,389432,149742,239690,6.9,17.9,332971,116754,216217,5.4,15.3,56461,2.6,30.6,0,8037,8037,54723
1997,48,314836,405257,7096523,6965191,56004,13.9,47907,11.9,1451072,569148,881924,8.2,20.8,1188408,469350,719058,6.7,17.1,262664,3.7,34.2,0,30005,30005,221243
1997,49,35632,43025,813824,793426,6968,16.6,4978,11.8,167048,70634,96414,8.9,21.1,126251,53515,72736,6.7,15.9,40797,5.2,31.8,0,3172,3172,22198
1997,50,16280,18510,229277,226070,2127,11.6,1802,9.8,36489,16295,20194,7.2,16.1,30075,11516,18559,5.1,13.3,6414,2.8,26.6,0,1217,1217,5988
1997,51,118075,150460,2576800,2520953,19479,13.1,15700,10.6,477997,179217,298780,7.1,19,366305,133813,232492,5.3,14.5,111692,4.5,29,0,9273,9273,55690
1997,53,113980,137198,2000012,1976162,19848,14.6,16893,12.4,396012,149801,246211,7.6,20,348313,154292,194021,7.8,17.6,47699,2.4,35.2,0,10334,10335,59622
1997,54,30416,37405,530398,525178,4271,11.5,3736,10,85196,31530,53666,6,16.2,74757,24147,50610,4.6,14.2,10439,2,28.4,0,2378,2378,12760
1997,55,100245,122547,2234478,2211260,13479,11.1,11311,9.3,328862,119840,209022,5.4,14.9,282426,97537,184889,4.4,12.8,46436,2.1,25.6,0,7022,7022,40433
1997,56,13168,15085,153473,151961,1918,12.7,1815,12,28970,10782,18188,7.1,19.1,25945,10104,15841,6.6,17.1,3025,2,34.2,0,1050,1050,4955
1998,1,71208,89777,1566400,1555852,10421,11.6,9869,11,250158,91774,158384,5.9,16.1,229062,93001,136061,6,14.7,21096,1.4,29.4,0,6667,6667,38943
1998,2,12575,15010,191000,186516,1987,13.3,1675,11.2,37036,14545,22491,7.8,19.9,28068,9436,18632,5.1,15,8968,4.9,30,0,1032,1032,4616
1998,4,75855,94834,1726180,1690405,13320,14.2,11415,12.1,342830,132406,210424,7.8,20.3,271281,113527,157754,6.7,16,71549,4.3,32,0,7536,7536,65445
1998,5,45400,55301,931538,921788,6494,11.8,6329,11.5,145814,57551,88263,6.2,15.8,126313,51150,75163,5.5,13.7,19501,2.1,27.4,0,4403,4403,23589
1998,6,547672,673801,11814940,11552872,87171,13,76367,11.4,2259779,831570,1428209,7.2,19.6,1735643,677970,1057673,5.9,15,524136,4.6,30,0,49794,49794,331540
1998,8,92984,111488,1720476,1675190,16121,14.7,12712,11.6,340099,133932,206167,8,20.3,249526,95994,153532,5.7,14.9,90573,5.4,29.8,0,8445,8445,49363
1998,9,69038,81961,1484372,1474721,8432,10.3,8256,10.1,230035,88484,141551,6,15.6,210732,72501,138231,4.9,14.3,19303,1.3,28.6,0,5285,5285,32962
1998,10,16278,19499,346054,341898,2455,12.7,2064,10.7,60565,24215,36350,7.1,17.7,52253,17460,34793,5.1,15.3,8312,2.4,30.6,0,1246,1246,8034
1998,11,14769,17788,400178,396336,1779,10,1752,9.8,58099,18885,39214,4.8,14.7,50415,15691,34724,4,12.7,7684,2,25.4,0,968,968,6749
1998,12,294317,362465,5632698,5520743,49765,13.8,46206,12.8,1115521,427099,688422,7.7,20.2,891611,375312,516299,6.8,16.2,223910,4,32.4,0,30956,30956,193308
1998,13,133263,169408,3111933,3067286,23281,13.9,19516,11.6,575660,226344,349316,7.4,18.8,486366,194564,291802,6.3,15.9,89294,2.9,31.8,0,12432,12432,86869
1998,15,21371,26798,414156,417565,2685,10,2864,10.6,56776,22741,34035,5.4,13.6,63593,24641,38952,5.9,15.2,-6817,-1.6,27.2,0,1795,1795,9526
1998,16,26005,30633,409134,398815,4209,13.9,3538,11.7,79109,34049,45060,8.5,19.8,58471,20752,37719,5.2,14.7,20638,5.1,29.4,0,2380,2380,11799
1998,17,219289,269075,5155211,5087637,28690,10.7,25421,9.5,798828,265571,533257,5.2,15.7,663679,227500,436179,4.5,13,135149,2.7,26,0,16471,16471,110580
1998,18,103278,131454,2494357,2463326,13817,10.6,12578,9.6,373256,137899,235357,5.6,15.2,311194,110916,200278,4.5,12.6,62062,2.6,25.2,0,8268,8268,51203
1998,19,58139,72406,1193958,1172704,6968,9.7,6344,8.8,172588,57858,114730,4.9,14.7,130080,43833,86247,3.7,11.1,42508,3.6,22.2,0,4136,4136,22132
1998,20,53620,65875,1057808,1040449,7362,11.2,6609,10.1,175316,66088,109228,6.4,16.9,140598,56762,83836,5.5,13.5,34718,3.4,27,0,4389,4389,26282
1998,21,64156,80379,1423764,1406534,9202,11.5,8024,10,228547,92574,135973,6.6,16.2,194086,66451,127635,4.7,13.8,34461,2.4,27.6,0,5307,5307,31218
1998,22,72595,90430,1509628,1486150,9993,11.1,9020,10,264391,93221,171170,6.3,17.8,217435,81436,135999,5.5,14.6,46956,3.2,29.2,0,5931,5931,42938
1998,23,27749,32665,450013,442526,3921,12.1,3181,9.8,67197,25854,41343,5.8,15.2,52223,20221,32002,4.6,11.8,14974,3.4,23.6,0,2179,2179,11828
1998,24,90004,110948,1921866,1898407,12804,11.6,11919,10.8,327126,127457,199669,6.7,17.2,280207,109594,170613,5.8,14.8,46919,2.4,29.6,0,7394,7394,50722
1998,25,122575,148597,2867650,2835724,15672,10.6,13776,9.3,449226,149562,299664,5.3,15.8,385374,127199,258175,4.5,13.6,63852,2.2,27.2,0,8874,8874,58681
1998,26,166603,206928,3877726,3829430,21785,10.6,20275,9.8,600023,215032,384991,5.6,15.7,503431,173612,329819,4.5,13.1,96592,2.6,26.2,0,13250,13250,85788
1998,27,96457,117464,2239620,2190600,12925,11.1,10421,9,367956,124502,243454,5.7,16.8,269915,90994,178921,4.2,12.3,98041,4.5,24.6,0,6726,6726,47576
1998,28,42902,53313,906379,893731,6165,11.6,5660,10.7,140180,51037,89143,5.7,15.7,114885,43595,71290,4.9,12.9,25295,2.8,25.8,0,3917,3917,23441
1998,29,103841,128472,2272133,2255174,14387,11.2,13302,10.4,337077,131585,205492,5.8,14.9,303159,100335,202824,4.4,13.4,33918,1.5,26.8,0,8890,8890,49302
1998,30,23045,26541,272713,269102,3500,13.3,2914,11.1,47452,20388,27064,7.6,17.6,40229,16853,23376,6.3,14.9,7223,2.7,29.8,0,2009,2009,8425
1998,31,35929,43485,706163,696733,4417,10.2,4020,9.3,103925,38502,65423,5.5,14.9,85065,31152,53913,4.5,12.2,18860,2.7,24.4,0,2688,2688,14172
1998,32,30788,37281,782869,765497,6385,17.5,4490,12.3,146550,65144,81406,8.5,19.1,111806,37411,74395,4.9,14.6,34744,4.5,29.2,0,3011,3011,19570
1998,33,27481,32249,506670,497719,3692,11.5,3157,9.9,81776,26886,54890,5.4,16.4,63873,24717,39156,5,12.8,17903,3.6,25.6,0,2053,2053,13097
1998,34,172242,200631,3331514,3295169,23792,11.9,20852,10.5,572481,210187,362294,6.4,17.4,499791,184852,314939,5.6,15.2,72690,2.2,30.4,0,13939,13939,81545
1998,35,30911,37438,519657,515038,4625,12.4,4260,11.4,91253,38625,52628,7.5,17.7,82015,33168,48847,6.4,15.9,9238,1.8,31.8,0,2761,2761,16875
1998,36,360321,421585,6959586,6878727,48680,11.6,43670,10.4,1164038,399093,764945,5.8,16.9,1002321,347668,654653,5.1,14.6,161717,2.3,29.2,0,30560,30560,173857
1998,37,139031,175933,3181451,3139345,22028,12.6,18873,10.8,509300,200723,308577,6.4,16.2,425087,169489,255598,5.4,13.5,84213,2.7,27,0,11665,11668,69870
1998,38,15292,18091,244086,243250,1723,9.5,1673,9.2,37907,13658,24249,5.6,15.6,36234,12840,23394,5.3,14.9,1673,0.7,29.8,0,1088,1088,6931
1998,39,189039,243178,4744570,4694273,24065,9.9,22513,9.3,717822,235413,482409,5,15.3,617227,225613,391614,4.8,13.1,100595,2.2,26.2,0,14188,14189,96200
1998,40,61555,75446,1140520,1117583,8842,11.8,8142,10.8,198327,74289,124038,6.6,17.7,152452,61556,90896,5.5,13.6,45875,4.1,27.2,0,5495,5497,31859
1998,41,72206,86437,1291371,1282228,10820,12.6,9638,11.2,215011,81082,133929,6.3,16.8,196725,73436,123289,5.7,15.3,18286,1.5,30.6,0,6230,6230,36217
1998,42,210262,264006,4859820,4814513,25891,9.8,23703,9,705630,245946,459684,5.1,14.7,615016,215387,399629,4.5,12.8,90614,1.9,25.6,0,15140,15140,96415
1998,44,22162,24910,399787,394473,2610,10.5,2413,9.7,59534,21077,38457,5.3,15.1,48905,16013,32892,4.1,12.4,10629,2.7,24.8,0,1649,1649,8194
1998,45,66799,84082,1490148,1463486,10561,12.7,8908,10.7,254738,102493,152245,7,17.4,201414,79927,121487,5.5,13.8,53324,3.6,27.6,0,5848,5848,34499
1998,46,17657,20666,285963,280604,2262,11,2066,10,43531,14965,28566,5.3,15.5,32813,12745,20068,4.5,11.7,10718,3.8,23.4,0,1419,1419,7088
1998,47,91596,117767,2276127,2240904,13938,11.9,12661,10.8,374771,149148,225623,6.7,16.7,304325,111239,193086,5,13.6,70446,3.1,27.2,0,8403,8404,54414
1998,48,317923,410702,7398022,7246862,52940,13,46297,11.3,1432931,549576,883355,7.6,19.8,1130611,428155,702456,5.9,15.6,302320,4.2,31.2,0,29957,29961,216413
1998,49,36535,44199,837644,825076,6553,15,5176,11.9,162060,68133,93927,8.3,19.6,136924,44989,91935,5.5,16.6,25136,3,33.2,0,3434,3434,23595
1998,50,16325,18495,237413,233674,1918,10.4,1887,10.2,35452,12472,22980,5.3,15.2,27976,10673,17303,4.6,12,7476,3.2,24,0,1286,1286,5678
1998,51,119624,152992,2641939,2609152,18554,12.2,15645,10.3,434240,167827,266413,6.4,16.6,368666,139548,229118,5.3,14.1,65574,2.5,28.2,0,9650,9650,59459
1998,53,115844,139677,2075386,2036127,18686,13.5,15813,11.4,371739,133581,238158,6.6,18.3,293220,108126,185094,5.3,14.4,78519,3.9,28.8,0,10448,10448,55991
1998,54,30393,37528,537429,534460,3770,10.1,3572,9.5,80440,30594,49846,5.7,15.1,74503,24516,49987,4.6,13.9,5937,1.2,27.8,0,2410,2410,12499
1998,55,100919,123497,2291560,2262706,12199,9.9,10879,8.8,318749,108267,210482,4.8,14.1,261042,88506,172536,3.9,11.5,57707,2.6,23,0,7176,7176,42420
1998,56,13402,15399,157186,155502,1937,12.7,1617,10.6,29039,12724,16315,8.2,18.7,25671,10792,14879,6.9,16.5,3368,2.2,33,0,1075,1075,5831
1999,1,71226,90355,1607274,1593735,10262,11.4,9545,10.6,259811,107542,152269,6.7,16.3,232732,84372,148360,5.3,14.6,27079,1.7,29.2,0,6394,6394,39774
1999,2,12622,15126,192563,192382,1769,11.7,1613,10.7,29337,9762,19575,5.1,15.2,28974,9254,19720,4.8,15.1,363,0.1,30.2,0,1028,1028,4475
1999,4,77304,97251,1798661,1762381,14038,14.6,11548,12,355176,144860,210316,8.2,20.2,282616,113836,168780,6.5,16,72560,4.2,32,0,7296,7296,56338
1999,5,45337,55549,947767,941073,6481,11.7,6161,11.1,145920,52818,93102,5.6,15.5,132531,52439,80092,5.6,14.1,13389,1.4,28.2,0,4176,4176,23719
1999,6,554919,683811,12129887,11987316,87591,12.9,76843,11.3,2230529,846102,1384427,7.1,18.6,1945387,756573,1188814,6.3,16.2,285142,2.4,32.4,0,48402,48402,340434
1999,8,95015,114451,1792129,1758877,16124,14.3,12964,11.5,347726,143666,204060,8.2,19.8,281222,115866,165356,6.6,16,66504,3.8,32,0,8342,8342,51052
1999,9,68697,82093,1517856,1501062,8031,9.8,7817,9.5,229648,80219,149429,5.3,15.3,196059,73281,122778,4.9,13.1,33589,2.2,26.2,0,5056,5056,30834
1999,10,16652,19920,348375,347237,2488,12.6,2051,10.4,54343,22600,31743,6.5,15.7,52067,18585,33482,5.4,15,2276,0.7,30,0,1182,1182,7526
1999,11,14735,17836,408206,404349,1808,10.1,1757,9.9,60372,22839,37533,5.6,14.9,52657,20111,32546,5,13,7715,1.9,26,0,933,933,6353
1999,12,296520,367221,5858561,5746221,51244,14,45661,12.5,1211620,440775,770845,7.7,21.1,986941,429665,557276,7.5,17.2,224679,3.9,34.4,0,30442,30442,194113
1999,13,135620,172745,3296208,3213288,22860,13.4,19317,11.3,635992,251867,384125,7.8,19.8,470151,189502,280649,5.9,14.6,165841,5.2,29.2,0,12217,12217,83655
1999,15,21192,26575,414069,413760,2542,9.5,2697,10.1,58520,24234,34286,5.9,14.1,57902,21233,36669,5.1,14,618,0.1,28,0,1696,1696,10250
1999,16,26589,31612,428898,421835,4366,14,3347,10.8,73664,30622,43042,7.3,17.5,59538,24062,35476,5.7,14.1,14126,3.4,28.2,0,2254,2254,12891
1999,17,219991,271071,5266503,5209512,27996,10.4,25857,9.6,789155,275686,513469,5.3,15.1,675175,238487,436688,4.6,13,113980,2.1,26,0,16176,16176,98472
1999,18,103119,132135,2554463,2532700,13279,10.1,12527,9.5,368488,125663,242825,5,14.5,324963,110135,214828,4.3,12.8,43525,1.7,25.6,0,8244,8244,54137
1999,19,57956,72649,1228892,1215590,6713,9.3,6395,8.8,172997,63041,109956,5.2,14.2,146392,49950,96442,4.1,12,26605,2.2,24,0,4225,4225,22379
1999,20,53677,66222,1094804,1079338,7002,10.6,6660,10.1,178817,67888,110929,6.3,16.6,147885,59875,88010,5.5,13.7,30932,2.9,27.4,0,4283,4283,26928
1999,21,64229,81004,1445386,1436443,8763,10.9,8053,10,218135,85302,132833,5.9,15.2,200248,69014,131234,4.8,13.9,17887,1.3,27.8,0,5354,5354,31293
1999,22,72521,90924,1546819,1542738,9510,10.5,9033,10,244370,88590,155780,5.7,15.8,236208,90522,145686,5.9,15.3,8162,0.5,30.6,0,5907,5907,45810
1999,23,28320,33383,465849,458619,3889,11.8,3154,9.5,71457,26373,45084,5.8,15.6,56996,19551,37445,4.3,12.4,14461,3.2,24.8,0,2082,2082,11405
1999,24,90544,111812,1951222,1937175,12480,11.2,11417,10.3,329395,124355,205040,6.4,17,301300,121089,180211,6.3,15.6,28095,1.4,31.2,0,6945,6945,54418
1999,25,123186,149622,2939939,2905520,15148,10.2,13971,9.4,469073,168418,300655,5.8,16.1,400235,141766,258469,4.9,13.8,68838,2.3,27.6,0,8817,8817,60581
1999,26,166554,208053,3943956,3915259,21020,10.1,19726,9.5,608039,226827,381212,5.8,15.5,550645,184314,366331,4.7,14.1,57394,1.4,28.2,0,12794,12794,88647
1999,27,97800,119573,2312467,2282437,12917,10.9,10749,9.1,347381,130838,216543,5.7,15.2,287321,106356,180965,4.7,12.6,60060,2.6,25.2,0,6620,6620,42288
1999,28,43007,53704,939482,931836,6148,11.5,5734,10.7,143994,50960,93034,5.5,15.5,128702,49091,79611,5.3,13.8,15292,1.7,27.6,0,3940,3940,23676
1999,29,103922,129335,2333454,2307353,14205,11,13271,10.3,361136,132344,228792,5.7,15.7,308936,114119,194817,4.9,13.4,52200,2.3,26.8,0,8811,8811,46241
1999,30,23246,26848,283822,278470,3196,12,2832,10.6,48796,18883,29913,6.8,17.5,38092,14904,23188,5.4,13.7,10704,3.8,27.4,0,1918,1918,8316
1999,31,36017,43709,729324,721885,4198,9.6,3967,9.1,107474,38057,69417,5.3,14.9,92595,36338,56257,5,12.8,14879,2.1,25.6,0,2587,2587,19727
1999,32,32249,39501,848121,818030,6937,18.1,4701,12.2,176495,77321,99174,9.5,21.6,116312,42830,73482,5.2,14.2,60183,7.4,28.4,0,3086,3086,22694
1999,33,27747,32765,520173,513357,3545,10.9,3004,9.2,73477,25960,47517,5.1,14.3,59845,19642,40203,3.8,11.7,13632,2.6,23.4,0,2019,2019,10749
1999,34,172972,202032,3405749,3367919,22553,11.2,20847,10.4,558235,211618,346617,6.3,16.6,482575,171381,311194,5.1,14.3,75660,2.3,28.6,0,13887,13887,81848
1999,35,30855,37771,536490,532128,4647,12.4,4290,11.4,92613,41007,51606,7.7,17.4,83889,29650,54239,5.6,15.8,8724,1.6,31.6,0,2797,2797,15055
1999,36,361184,424972,7072574,7018426,47235,11.2,43329,10.2,1080517,397436,683081,5.7,15.4,972222,356910,615312,5.1,13.9,108295,1.5,27.8,0,30135,30135,179820
1999,37,141415,179381,3276634,3233451,21774,12.3,18066,10.2,554407,215457,338950,6.7,17.1,468043,179110,288933,5.5,14.5,86364,2.6,29,0,11531,11531,81785
1999,38,15230,18096,247156,246499,1547,8.6,1530,8.5,33255,13287,19968,5.4,13.5,31941,10588,21353,4.3,13,1314,0.5,26,0,1010,1010,5068
1999,39,188947,244333,4808602,4780486,23335,9.6,21886,9,693972,249088,444884,5.2,14.5,637740,221190,416550,4.6,13.3,56232,1.2,26.6,0,13729,13729,88511
1999,40,61441,75675,1156159,1151503,8761,11.6,8305,11,194935,76305,118630,6.6,16.9,185623,70172,115451,6.1,16.1,9312,0.8,32.2,0,5441,5441,32676
1999,41,72484,87355,1308883,1299868,10708,12.3,9641,11.1,214712,80813,133899,6.2,16.5,196682,79115,117567,6.1,15.1,18030,1.4,30.2,0,6328,6328,35747
1999,42,210284,264924,4907638,4884266,25024,9.5,23905,9,684252,237963,446289,4.9,14,637508,217508,420000,4.5,13.1,46744,0.9,26.2,0,15144,15144,97576
1999,44,22059,24980,402622,400870,2520,10.1,2423,9.7,56033,18318,37715,4.6,14,52529,18180,34349,4.5,13.1,3504,0.9,26.2,0,1724,1724,8506
1999,45,68148,85897,1539910,1518441,10787,12.7,8881,10.4,251710,98275,153435,6.5,16.6,208771,70852,137919,4.7,13.7,42939,2.9,27.4,0,5706,5706,34157
1999,46,17734,20855,291858,288983,2210,10.6,2010,9.7,41190,17149,24041,5.9,14.3,35439,13015,22424,4.5,12.3,5751,2,24.6,0,1366,1366,6378
1999,47,91240,118263,2309987,2297376,13486,11.4,12874,10.9,369736,144260,225476,6.3,16.1,344514,130806,213708,5.7,15,25222,1.1,30,0,8267,8267,51318
1999,48,318419,415122,7615006,7533601,52044,12.6,47200,11.4,1436453,557424,879029,7.4,19.1,1273644,508370,765274,6.7,16.9,162809,2.2,33.8,0,30512,30512,224095
1999,49,37552,45909,873760,862915,7074,15.7,5306,11.8,154245,64048,90197,7.4,17.9,132554,53002,79552,6.1,15.4,21691,2.5,30.8,0,3526,3526,28091
1999,50,16425,18759,243971,240762,1902,10.2,1638,8.8,33859,12189,21670,5.1,14.1,27442,9688,17754,4,11.4,6417,2.7,22.8,0,1155,1155,6687
1999,51,120391,154433,2741950,2699999,17574,11.4,15937,10.4,452728,169443,283285,6.3,16.8,368827,134892,233935,5,13.7,83901,3.1,27.4,0,9640,9640,55978
1999,53,116654,141178,2141563,2110950,18325,13,16512,11.8,377716,151450,226266,7.2,17.9,316491,119609,196882,5.7,15,61225,2.9,30,0,10671,10671,61031
1999,54,30316,37503,536953,537972,3728,9.9,3740,10,72853,28109,44744,5.2,13.5,74891,26923,47968,5,13.9,-2038,-0.4,27,0,2422,2422,12209
1999,55,101224,124477,2332680,2312146,11980,9.7,10893,8.8,314991,103607,211384,4.5,13.6,273924,93482,180442,4,11.8,41067,1.8,23.6,0,7146,7146,43775
1999,56,13379,15484,165955,163408,1836,11.9,1732,11.2,29721,10673,19048,6.5,18.2,24626,9886,14740,6,15.1,5095,3.1,30.2,0,1163,1163,5258
2000,1,70605,90110,1642939,1625120,9606,10.6,9905,11,262546,88217,174329,5.4,16.2,226908,85107,141801,5.2,14,35638,2.2,28,0,6315,6315,37543
2000,2,12621,15141,201596,197254,1853,12.2,1852,12.2,40049,15367,24682,7.8,20.3,31364,14307,17057,7.3,15.9,8685,4.4,31.8,0,1013,1013,5388
2000,4,77986,98977,1885437,1842806,13717,14,11979,12.2,379599,153540,226059,8.3,20.6,294339,110758,183581,6,16,85260,4.6,32,0,7348,7348,49000
2000,5,44946,55463,985189,965435,6167,11.1,6260,11.3,157857,56753,101104,5.9,16.4,118348,44694,73654,4.6,12.3,39509,4.1,24.6,0,3939,3939,21618
2000,6,562032,693823,12629377,12364805,87476,12.7,77827,11.3,2446672,902201,1544471,7.3,19.8,1917528,774321,1143207,6.3,15.5,529144,4.3,31,0,47748,47748,340832
2000,8,96534,116722,1878396,1835917,15953,13.8,13663,11.8,359547,138860,220687,7.6,19.6,274588,108128,166460,5.9,15,84959,4.6,30,0,8230,8230,49218
2000,9,68707,82196,1535232,1527132,7876,9.6,7856,9.6,221275,75744,145531,5,14.5,205075,73867,131208,4.8,13.4,16200,1.1,26.8,0,4766,4766,25734
2000,10,17022,20473,369123,359032,2689,13.3,2148,10.6,70689,32431,38258,9,19.7,50507,19617,30890,5.5,14.1,20182,5.6,28.2,0,1212,1212,7039
2000,11,14742,17967,421406,414648,1773,9.9,1647,9.2,63060,22362,40698,5.4,15.2,49545,14065,35480,3.4,11.9,13515,3.3,23.8,0,859,859,6148
2000,12,296941,369051,6161178,6023537,49454,13.4,47522,12.9,1254153,485807,768346,8.1,20.8,978871,433219,545652,7.2,16.3,275282,4.5,32.6,0,29768,29768,202059
2000,13,136546,175138,3412831,3358472,22995,13.2,20678,11.9,628482,245278,383204,7.3,18.7,519765,215256,304509,6.4,15.5,108717,3.2,31,0,12388,12388,80036
2000,15,21402,26774,429645,421650,2670,10,2504,9.4,63684,24280,39404,5.8,15.1,47695,20748,26947,4.9,11.3,15989,3.8,22.6,0,1498,1498,8552
2000,16,26833,31987,442769,435862,4133,13,3779,11.9,80476,34072,46404,7.8,18.5,66662,24139,42523,5.5,15.3,13814,3.2,30.6,0,2309,2309,12315
2000,17,220148,272345,5404827,5335037,28282,10.4,26965,9.9,874785,300422,574363,5.6,16.4,735205,276397,458808,5.2,13.8,139580,2.6,27.6,0,16071,16071,109919
2000,18,102584,131901,2630083,2591613,13027,9.9,13314,10.1,395863,138031,257832,5.3,15.3,318922,117740,201182,4.5,12.3,76941,3,24.6,0,8032,8032,52725
2000,19,57732,72637,1288179,1257916,6572,9,6609,9.1,203688,65491,138197,5.2,16.2,143161,51513,91648,4.1,11.4,60527,4.8,22.8,0,4078,4078,22490
2000,20,53573,66496,1113366,1102648,7084,10.7,6824,10.3,176065,71165,104900,6.5,16,154630,57253,97377,5.2,14,21435,2,28,0,4161,4161,23114
2000,21,63942,81192,1511190,1485242,8494,10.5,8290,10.2,238322,90365,147957,6.1,16,186425,69308,117117,4.7,12.6,51897,3.4,25.2,0,5237,5237,34706
2000,22,71957,90899,1569621,1558469,9556,10.5,9650,10.6,268667,111519,157148,7.2,17.2,246363,91500,154863,5.9,15.8,22304,1.4,31.6,0,5829,5829,48275
2000,23,28593,33823,484757,474661,3705,11,3243,9.7,75720,28532,47188,6,16,55527,21676,33851,4.6,11.7,20193,4.3,23.4,0,2102,2102,11042
2000,24,90649,112482,2030264,1990455,12335,11,11652,10.4,355723,125423,230300,6.3,17.9,276106,106272,169834,5.3,13.9,79617,4,27.8,0,6849,6849,42207
2000,25,124067,151204,3030442,2982280,15594,10.4,14084,9.4,506031,170567,335464,5.7,17,409706,153114,256592,5.1,13.7,96325,3.3,27.4,0,8543,8543,58763
2000,26,166767,208588,4017154,3981059,21099,10.1,20625,9.9,639071,223041,416030,5.6,16.1,566882,221072,345810,5.6,14.2,72189,1.9,28.4,0,12106,12106,84082
2000,27,98648,121051,2385672,2349902,12536,10.4,11080,9.2,360454,118146,242308,5,15.3,288914,93695,195219,4,12.3,71540,3,24.6,0,6655,6655,44305
2000,28,42472,53657,947782,942816,5865,10.9,5939,11.1,136571,51558,85013,5.5,14.5,126639,46377,80262,4.9,13.4,9932,1.1,26.8,0,3811,3811,21467
2000,29,103816,129818,2372582,2352298,14137,10.9,13672,10.6,367833,132633,235200,5.6,15.6,327266,114989,212277,4.9,13.9,40567,1.7,27.8,0,8628,8628,49155
2000,30,23415,27182,294585,289227,3286,12.2,2934,10.9,49419,18034,31385,6.2,17.1,38703,14861,23842,5.1,13.4,10716,3.7,26.8,0,1916,1916,8163
2000,31,36082,44059,751717,743016,4358,9.9,3986,9.1,112404,43042,69362,5.8,15.1,95001,34325,60676,4.6,12.8,17403,2.3,25.6,0,2412,2412,16971
2000,32,33098,40767,903007,876136,6655,16.6,5356,13.3,180708,72828,107880,8.3,20.6,126966,47476,79490,5.4,14.5,53742,6.1,29,0,3315,3315,22568
2000,33,27954,33109,539125,529538,3500,10.6,3218,9.8,85655,29547,56108,5.6,16.2,66482,24187,42295,4.6,12.6,19173,3.6,25.2,0,1974,1974,11344
2000,34,173288,203544,3505397,3456552,22814,11.3,21305,10.5,607273,211748,395525,6.1,17.6,509583,198150,311433,5.7,14.7,97690,2.9,29.4,0,13461,13461,81069
2000,35,30584,37731,542075,538254,4455,11.8,4489,11.9,94264,38395,55869,7.1,17.5,86622,34317,52305,6.4,16.1,7642,1.4,32.2,0,2735,2735,16440
2000,36,363085,429095,7293156,7180654,47759,11.2,43678,10.2,1182378,421077,761301,5.9,16.5,957375,368746,588629,5.1,13.3,225003,3.2,26.6,0,28553,28553,170845
2000,37,141653,180800,3356064,3314147,20574,11.4,19155,10.6,536635,199723,336912,6,16.2,452801,171935,280866,5.2,13.7,83834,2.5,27.4,0,11769,11769,71742
2000,38,15081,18042,253866,250591,1564,8.7,1614,8.9,36038,13023,23015,5.2,14.4,29488,10440,19048,4.2,11.8,6550,2.6,23.6,0,1069,1069,6058
2000,39,188316,244803,4962694,4886858,23163,9.5,22700,9.3,781934,266716,515218,5.5,16,630264,221473,408791,4.5,12.9,151670,3.1,25.8,0,13583,13583,87228
2000,40,61092,75661,1196307,1176912,8289,11,8391,11.1,203471,79015,124456,6.7,17.3,164680,62775,101905,5.3,14,38791,3.3,28,0,5243,5243,29021
2000,41,72302,87444,1335226,1324292,10006,11.5,9976,11.4,219364,85101,134263,6.4,16.6,197496,77129,120367,5.8,14.9,21868,1.7,29.8,0,6134,6134,33249
2000,42,210441,266130,5037557,4969163,25154,9.5,23955,9,774302,290671,483631,5.8,15.6,637513,223710,413803,4.5,12.8,136789,2.8,25.6,0,14523,14523,88772
2000,44,22084,25112,408255,404731,2534,10.1,2381,9.5,67930,26656,41274,6.6,16.8,60881,26334,34547,6.5,15,7049,1.8,30,0,1544,1544,11530
2000,45,68338,86592,1582808,1560813,10089,11.7,9401,10.9,259177,94541,164636,6.1,16.6,215187,82615,132572,5.3,13.8,43990,2.8,27.6,0,5817,5817,35466
2000,46,17779,20945,300600,296059,2107,10.1,2007,9.6,47004,16504,30500,5.6,15.9,37922,14126,23796,4.8,12.8,9082,3.1,25.6,0,1296,1296,7070
2000,47,90412,118260,2372685,2340729,13085,11.1,13161,11.1,406028,148212,257816,6.3,17.3,342115,134908,207207,5.8,14.6,63913,2.7,29.2,0,7954,7954,49068
2000,48,318567,417404,7885222,7746944,50948,12.2,48856,11.7,1505995,571448,934547,7.4,19.4,1229439,499633,729806,6.4,15.9,276556,3.5,31.8,0,29207,29207,208591
2000,49,38191,47090,904607,889237,6722,14.5,5514,11.9,161992,61958,100034,7,18.2,131252,48407,82845,5.4,14.8,30740,3.4,29.6,0,3489,3489,24354
2000,50,16518,18923,252376,248037,1839,9.8,1665,8.8,38249,13414,24835,5.4,15.4,29570,10382,19188,4.2,11.9,8679,3.5,23.8,0,1083,1083,5465
2000,51,121173,156056,2850032,2791425,17667,11.4,15949,10.3,501295,183507,317788,6.6,18,384081,151210,232871,5.4,13.8,117214,4.2,27.6,0,9335,9335,51611
2000,53,116795,141838,2223260,2182488,17524,12.4,16919,12,400895,146997,253898,6.7,18.4,319352,119350,200002,5.5,14.6,81543,3.8,29.2,0,10384,10397,54377
2000,54,30008,37408,552102,544664,3646,9.7,3725,9.9,81537,31389,50148,5.8,15,66661,23560,43101,4.3,12.2,14876,2.8,24.4,0,2295,2295,12139
2000,55,101236,125383,2390435,2361456,12144,9.7,11166,8.9,332622,116298,216324,4.9,14.1,274664,95378,179286,4,11.6,57958,2.5,23.2,0,7028,7028,40805
2000,56,13535,15698,171698,168742,1841,11.8,1636,10.5,30167,11184,18983,6.6,17.9,24254,9232,15022,5.5,14.4,5913,3.5,28.8,0,1048,1048,4696
2001,1,70352,90414,1604484,1628485,9579,10.6,10413,11.5,221154,86339,134815,5.3,13.6,269155,92197,176958,5.7,16.5,-48001,-2.9,27.2,0,6200,6202,42563
2001,2,12692,15346,211116,207531,1856,12.1,1833,12,37813,13481,24332,6.5,18.2,30642,11244,19398,5.4,14.8,7171,3.4,29.6,0,972,972,5256
2001,4,79891,101849,1934020,1915698,14287,14.2,12452,12.4,368803,156770,212033,8.2,19.3,332159,128544,203615,6.7,17.3,36644,2,34.6,0,7102,7104,49531
2001,5,45763,56764,986598,988856,6411,11.3,6347,11.2,142467,52554,89913,5.3,14.4,146982,48760,98222,4.9,14.9,-4515,-0.5,28.8,0,3845,3846,21206
2001,6,573961,711141,13142215,12970319,91579,13,83319,11.8,2432918,899379,1533539,6.9,18.8,2089126,778077,1311049,6,16.1,343792,2.7,32.2,0,49736,49773,338902
2001,8,99494,120913,1952821,1921921,17024,14.3,14404,12.1,384496,154742,229754,8.1,20,322696,123729,198967,6.4,16.8,61800,3.2,33.6,0,8461,8465,51699
2001,9,68735,82921,1562369,1554126,8164,9.9,8114,9.8,231050,88492,142558,5.7,14.9,214563,78061,136502,5,13.8,16487,1.1,27.6,0,4763,4764,27559
2001,10,17512,21205,379109,375041,2599,12.4,2186,10.5,61962,21668,40294,5.8,16.5,53825,17758,36067,4.7,14.4,8137,2.1,28.8,0,1230,1231,8373
2001,11,14949,18275,429243,426919,1857,10.2,1711,9.4,64753,24925,39828,5.8,15.2,60106,21388,38718,5,14.1,4647,1.1,28.2,0,835,837,5705
2001,12,303014,378176,6458253,6370230,52450,14,47439,12.7,1320806,501845,818961,7.9,20.7,1144761,412821,731940,6.5,18,176045,2.7,36,0,28382,28400,174858
2001,13,139184,179140,3439237,3443269,23239,13.1,21384,12,575180,239304,335876,6.9,16.7,583245,203942,379303,5.9,16.9,-8065,-0.2,33.4,0,12082,12085,81285
2001,15,21851,27402,449582,442459,2854,10.5,2522,9.3,68595,29944,38651,6.8,15.5,54349,20869,33480,4.7,12.3,14246,3.2,24.6,0,1432,1434,10295
2001,16,27781,33077,472961,460399,4514,13.7,4327,13.2,94877,45078,49799,9.8,20.6,69752,26875,42877,5.8,15.2,25125,5.4,30.4,0,2284,2285,13011
2001,17,223324,277020,5390095,5413887,27889,10.1,27950,10.1,769138,286228,482910,5.3,14.2,816724,266147,550577,4.9,15.1,-47586,-0.9,28.4,0,16108,16130,103128
2001,18,103115,133129,2591090,2627690,13224,9.9,13804,10.4,348302,124243,224059,4.7,13.3,421501,152970,268531,5.8,16,-73199,-2.7,26.6,0,7888,7897,53828
2001,19,59702,74983,1252718,1276068,6843,9.1,7410,9.9,150600,56261,94339,4.4,11.8,197299,51263,146036,4,15.5,-46699,-3.7,23.6,0,4095,4096,22350
2001,20,55108,68414,1109300,1115903,7341,10.8,7346,10.8,151750,60430,91320,5.4,13.6,164957,56535,108422,5.1,14.8,-13207,-1.2,27.2,0,4211,4212,25665
2001,21,64734,82265,1504231,1512923,8423,10.3,8558,10.4,205186,73082,132104,4.8,13.6,222570,75670,146900,5,14.7,-17384,-1.1,27.2,0,4979,4986,30977
2001,22,72723,92013,1581622,1581364,9600,10.5,9785,10.7,246730,94517,152213,6,15.6,246215,82813,163402,5.2,15.6,515,0,31.2,0,5573,5575,35959
2001,23,29074,34615,493600,490611,3841,11.2,3479,10.1,70870,28895,41975,5.9,14.4,64892,22072,42820,4.5,13.2,5978,1.2,26.4,0,2125,2128,10413
2001,24,92304,114702,2076774,2058317,13011,11.4,11897,10.5,327801,126378,201423,6.1,15.9,290887,106635,184252,5.2,14.1,36914,1.8,28.2,0,6554,6560,45967
2001,25,126821,154653,3085608,3065040,15872,10.3,14984,9.7,478107,160207,317900,5.2,15.6,436971,147128,289843,4.8,14.3,41136,1.3,28.6,0,8731,8735,67015
2001,26,167416,210769,3979922,4007290,21452,10.2,21853,10.4,597434,226012,371422,5.6,14.9,652170,218309,433861,5.4,16.3,-54736,-1.4,29.8,0,12498,12505,87824
2001,27,102014,125856,2425594,2412422,14067,11.3,12085,9.7,361204,137112,224092,5.7,15,334861,112077,222784,4.6,13.9,26343,1.1,27.8,0,6692,6697,46287
2001,28,42622,54006,922065,938467,5846,10.8,6436,11.9,124917,47998,76919,5.1,13.3,157721,54279,103442,5.8,16.8,-32804,-3.5,26.6,0,3758,3758,21888
2001,29,104466,131359,2387354,2385764,13534,10.3,14062,10.7,343554,126487,217067,5.3,14.4,340375,114010,226365,4.8,14.3,3179,0.1,28.6,0,8471,8473,49694
2001,30,24325,28294,302503,299993,3432,12.3,3041,10.9,48292,19137,29155,6.4,16.1,43272,14509,28763,4.8,14.4,5020,1.7,28.8,0,1761,1762,8150
2001,31,38314,46613,773856,765649,4899,10.6,4516,9.8,126410,44431,81979,5.8,16.5,109996,38977,71019,5.1,14.4,16414,2.1,28.8,0,2415,2415,13476
2001,32,33992,42016,922055,913889,6684,16.1,5866,14.1,158812,64770,94042,7.1,17.4,142479,50463,92016,5.5,15.6,16333,1.8,31.2,0,3588,3590,26051
2001,33,28202,33515,554538,547692,3521,10.6,3389,10.2,86115,30346,55769,5.5,15.7,72423,26027,46396,4.8,13.2,13692,2.5,26.4,0,2067,2068,12611
2001,34,175196,206688,3606308,3562430,23279,11.3,21971,10.7,612255,243817,368438,6.8,17.2,524500,182799,341701,5.1,14.7,87755,2.5,29.4,0,13359,13360,85297
2001,35,31064,38411,556023,565812,4618,12.1,4579,12,97003,39102,57901,6.9,17.1,116581,34845,81736,6.2,20.6,-19578,-3.5,34.2,0,2502,2502,14776
2001,36,369423,436645,7367414,7350406,48700,11.2,45828,10.6,1082064,401540,680524,5.5,14.7,1048048,375562,672486,5.1,14.3,34016,0.4,28.6,0,28475,28495,174338
2001,37,144432,184776,3439861,3409449,21761,11.9,20013,10.9,581854,217312,364542,6.4,17.1,521031,183545,337486,5.4,15.3,60823,1.8,30.6,0,11514,11521,67024
2001,38,16312,19377,258827,257894,1924,10,1831,9.5,34567,14709,19858,5.7,13.4,32700,10659,22041,4.1,12.7,1867,0.7,25.4,0,1001,1001,5892
2001,39,188752,246903,4904685,4945573,23133,9.4,23478,9.5,659649,243835,415814,4.9,13.3,741424,230593,510831,4.7,15,-81775,-1.7,26.6,0,13438,13459,88243
2001,40,61924,77039,1205284,1204587,8557,11.1,8597,11.2,193385,74441,118944,6.2,16.1,191992,74583,117409,6.2,15.9,1393,0.2,31.8,0,5106,5108,29354
2001,41,73811,89703,1349222,1347916,10920,12.3,10195,11.4,213014,81725,131289,6.1,15.8,210403,66346,144057,4.9,15.6,2611,0.2,31.2,0,5993,6005,30912
2001,42,212345,270136,5095461,5078013,26059,9.7,24759,9.2,736710,285939,450771,5.6,14.5,701813,236638,465175,4.7,13.8,34897,0.7,27.6,0,14433,14439,97900
2001,44,22247,25373,408537,408840,2542,10.1,2461,9.7,53496,19744,33752,4.8,13.1,54102,15408,38694,3.8,13.2,-606,-0.1,26.2,0,1549,1549,7742
2001,45,68858,87557,1587983,1591931,10064,11.5,10077,11.5,238832,91848,146984,5.8,15,246728,82509,164219,5.2,15.5,-7896,-0.5,30,0,6013,6018,36457
2001,46,18844,22156,314496,309894,2384,10.8,2264,10.3,50367,22637,27730,7.3,16.3,41163,13227,27936,4.3,13.3,9204,3,26.6,0,1253,1254,6607
2001,47,90382,118917,2362632,2372654,12890,10.8,13565,11.4,359872,132876,226996,5.6,15.2,379916,134737,245179,5.7,16,-20044,-0.8,30.4,0,7906,7912,58107
2001,48,325347,428570,8077011,8002854,53576,12.6,49264,11.6,1471663,608449,863214,7.6,18.4,1323348,509596,813752,6.4,16.5,148315,1.9,33,0,28694,28721,196834
2001,49,39455,48480,910180,909652,7166,15,6343,13.2,166581,65712,100869,7.2,18.3,165525,66388,99137,7.3,18.2,1056,0.1,36.4,0,3528,3533,27760
2001,50,16837,19355,260404,257417,1799,9.3,1705,8.9,35214,12893,22321,5,13.7,29240,9564,19676,3.7,11.4,5974,2.3,22.8,0,1086,1086,5401
2001,51,123619,159418,2910180,2887880,17985,11.4,16517,10.4,480849,188948,291901,6.5,16.7,436249,138781,297468,4.8,15.1,44600,1.6,30.2,0,9117,9122,54894
2001,53,118451,144655,2253249,2246102,18242,12.7,17391,12.1,374446,147240,227206,6.6,16.7,360152,127557,232595,5.7,16,14294,0.7,32,0,10098,10109,62867
2001,54,29621,37057,549533,552773,3302,8.8,4016,10.8,74778,25382,49396,4.6,13.5,81260,30502,50758,5.5,14.7,-6482,-1.2,27,0,2340,2341,11283
2001,55,104551,129500,2391503,2406905,12412,9.6,12048,9.3,304095,114961,189134,4.8,12.6,334898,116735,218163,4.9,13.9,-30803,-1.3,25.2,0,6975,6986,42196
2001,56,13953,16158,175346,174285,1906,11.8,1872,11.6,28437,10464,17973,6,16.3,26315,9274,17041,5.3,15.1,2122,1.2,30.2,0,1067,1068,5021
2002,1,70560,90997,1573683,1589994,11121,12.3,10424,11.5,256035,105392,150643,6.6,16.1,288656,99203,189453,6.2,18.2,-32621,-2.1,32.2,0,5794,5803,34440
2002,2,12859,15607,214252,212307,2251,14.6,1928,12.5,40880,16158,24722,7.6,19.3,36989,11902,25087,5.6,17.4,3891,1.9,34.8,0,933,935,4982
2002,4,81092,103597,1923192,1927240,15479,15.1,13692,13.3,384148,163175,220973,8.5,19.9,392244,138105,254139,7.2,20.4,-8096,-0.5,39.8,0,7345,7367,50007
2002,5,46368,57729,976349,980637,7611,13.3,6557,11.5,161116,68062,93054,6.9,16.4,169691,62905,106786,6.4,17.3,-8575,-0.9,32.8,0,3711,3715,20059
2002,6,579815,720108,12803211,12945678,102339,14.3,91684,12.8,2420870,1042678,1378192,8.1,18.7,2705804,962658,1743146,7.4,20.9,-284934,-2.2,37.4,0,51119,51271,402745
2002,8,100610,122276,1872838,1912063,18035,14.8,16406,13.5,341975,146952,195023,7.7,17.9,420424,160491,259933,8.4,22,-78449,-4.1,35.8,0,8593,8607,51377
2002,9,68339,82632,1557823,1556215,8853,10.7,8976,10.9,249429,98275,151154,6.3,16,246213,79416,166797,5.1,15.8,3216,0.2,31.6,0,4551,4554,27381
2002,10,17573,21637,386136,383441,2925,13.7,2450,11.4,70231,33001,37230,8.6,18.3,64841,21611,43230,5.6,16.9,5390,1.4,33.8,0,1235,1241,6143
2002,11,15161,18538,428521,428439,2287,12.4,2028,11,71440,30405,41035,7.1,16.7,71276,23087,48189,5.4,16.6,164,0.1,33.2,0,865,868,7973
2002,12,309531,384961,6302235,6331710,58793,15.4,51634,13.5,1237292,513944,723348,8.1,19.5,1296242,577707,718535,9.1,20.5,-58950,-1,39,0,28485,28546,192169
2002,13,141528,181788,3370470,3401655,26063,14.5,23184,12.9,595909,267091,328818,7.9,17.5,658279,244844,413435,7.2,19.4,-62370,-1.9,35,0,11975,12000,90743
2002,15,22123,27663,440258,445157,3253,11.8,2950,10.7,68096,28453,39643,6.4,15.3,77894,23354,54540,5.2,17.5,-9798,-2.2,30.6,0,1513,1517,8861
2002,16,28397,33808,456810,463866,5012,15,4194,12.6,84228,38072,46156,8.2,18.2,98339,32748,65591,7.1,21.2,-14111,-3,36.4,0,2100,2119,16564
2002,17,222368,276345,5197514,5286610,31928,11.5,32234,11.7,811852,335498,476354,6.3,15.4,990045,341243,648802,6.5,18.7,-178193,-3.3,30.8,0,15671,15742,107409
2002,18,103605,133795,2517025,2549100,15500,11.6,14748,11.1,379062,161812,217250,6.3,14.9,443214,143735,299479,5.6,17.4,-64152,-2.5,29.8,0,7363,7392,48115
2002,19,59930,75312,1235856,1241651,8262,11,7761,10.3,173380,74619,98761,6,14,184969,62553,122416,5,14.9,-11589,-0.9,28,0,3676,3687,21762
2002,20,55442,68925,1099878,1103459,8475,12.4,7870,11.5,180872,77738,103134,7,16.4,188034,62862,125172,5.7,17,-7162,-0.6,32.8,0,4010,4017,23022
2002,21,64904,82893,1476176,1488225,9609,11.6,8881,10.8,224493,91835,132658,6.2,15.1,248590,75856,172734,5.1,16.7,-24097,-1.6,30.2,0,4815,4831,28367
2002,22,73499,92883,1565911,1570766,10887,11.8,9908,10.7,264978,108385,156593,6.9,16.9,274689,95809,178880,6.1,17.5,-9711,-0.6,33.8,0,5332,5342,39421
2002,23,29042,34773,481934,487126,4113,11.9,3956,11.4,72071,31198,40873,6.4,14.8,82454,28986,53468,6,16.9,-10383,-2.1,29.6,0,2059,2060,12461
2002,24,93592,116262,2054207,2059192,14706,12.7,13000,11.3,344826,145495,199331,7.1,16.7,354796,127501,227295,6.2,17.2,-9970,-0.5,33.4,0,6451,6464,48775
2002,25,127076,155796,2992687,3034122,17823,11.5,16458,10.6,475818,191176,284642,6.3,15.7,558688,190357,368331,6.3,18.4,-82870,-2.7,31.4,0,8504,8512,64263
2002,26,166313,209474,3874945,3925249,24622,11.7,25566,12.2,628800,270151,358649,6.9,16,729408,259120,470288,6.6,18.6,-100608,-2.6,32,0,12337,12376,86424
2002,27,102388,126706,2366641,2390113,15326,12.1,14310,11.3,368345,144915,223430,6.1,15.4,415289,151050,264239,6.3,17.4,-46944,-2,30.8,0,6842,6854,45274
2002,28,43043,54546,901567,909045,6834,12.6,6257,11.5,141935,61902,80033,6.8,15.6,156891,56927,99964,6.3,17.3,-14956,-1.7,31.2,0,3479,3485,20355
2002,29,105466,132836,2346777,2364419,16996,12.9,15323,11.6,378641,158708,219933,6.7,16,413925,139365,274560,5.9,17.5,-35284,-1.5,32,0,8186,8195,53297
2002,30,24578,28636,301026,300768,3755,13.2,3368,11.8,51558,20725,30833,6.9,17.1,51041,16671,34370,5.5,17,517,0.1,34,0,1757,1758,7790
2002,31,38793,47274,751431,760854,5521,11.8,4811,10.3,113476,43820,69656,5.8,14.9,132321,35068,97253,4.6,17.4,-18845,-2.5,29.8,0,2371,2375,12585
2002,32,34995,43428,932002,928290,7512,17.6,6027,14.1,177632,80254,97378,8.6,19.1,170207,54321,115886,5.9,18.3,7425,0.8,36.6,0,3427,3429,24379
2002,33,28080,33536,537850,544787,3801,11.3,3725,11.1,79010,31083,47927,5.7,14.5,92883,32787,60096,6,17,-13873,-2.5,29,0,2049,2050,11750
2002,34,175338,207741,3577176,3580753,25460,12.3,24127,11.7,614353,233800,380553,6.5,17.2,621508,215054,406454,6,17.4,-7155,-0.2,34.4,0,13415,13436,82153
2002,35,31392,38678,558146,554511,5114,13.3,4802,12.5,106940,46510,60430,8.4,19.3,99669,35926,63743,6.5,18,7271,1.3,36,0,2441,2442,14842
2002,36,370644,438352,7273823,7314216,54109,12.4,51627,11.8,1234501,507664,726837,6.9,16.9,1315286,496213,819073,6.8,18,-80785,-1.1,33.8,0,29064,29095,183767
2002,37,144898,185875,3338628,3383227,22975,12.4,21690,11.7,519727,225442,294285,6.7,15.4,608924,202509,406415,6,18,-89197,-2.6,30.8,0,11460,11495,67944
2002,38,16380,19556,255364,256926,2192,11.3,1967,10.1,37874,17626,20248,6.9,14.7,40998,14030,26968,5.5,16,-3124,-1.3,29.4,0,927,927,5860
2002,39,187731,245824,4751911,4818157,26006,10.6,26776,10.9,729937,290981,438956,6,15.1,862428,271782,590646,5.6,17.9,-132491,-2.8,30.2,0,13080,13109,93897
2002,40,62904,77936,1192069,1194789,9899,12.8,8897,11.5,211025,86807,124218,7.3,17.7,216465,80064,136401,6.7,18.1,-5440,-0.4,35.4,0,4760,4777,32950
2002,41,74048,90224,1325320,1335737,11699,13,10945,12.2,222747,96297,126450,7.2,16.7,243580,82998,160582,6.2,18.2,-20833,-1.5,33.4,0,5808,5823,32862
2002,42,212361,270273,5064436,5071475,28658,10.6,28089,10.4,820718,335684,485034,6.6,16.2,834796,319617,515179,6.3,16.5,-14078,-0.3,32.4,0,13940,13985,100057
2002,44,22172,25382,414212,411997,2809,11.1,2763,10.9,64326,26751,37575,6.5,15.6,59895,19181,40714,4.7,14.5,4431,1.1,29,0,1469,1469,7191
2002,45,69339,88406,1532509,1555278,11185,12.7,10298,11.7,239378,98551,140827,6.3,15.4,284917,90626,194291,5.8,18.3,-45539,-2.9,30.8,0,5687,5698,35200
2002,46,19330,22781,304203,309201,2998,13.4,2326,10.4,50361,19433,30928,6.3,16.3,60357,23626,36731,7.6,19.5,-9996,-3.2,32.6,0,1227,1227,7241
2002,47,90030,118670,2286252,2319660,14261,12,14357,12.1,364965,149282,215683,6.4,15.7,431781,151288,280493,6.5,18.6,-66816,-2.9,31.4,0,7689,7714,50478
2002,48,329782,434097,7964399,7997968,59389,13.8,53415,12.4,1501267,674867,826400,8.4,18.8,1568407,569713,998694,7.1,19.6,-67140,-0.8,37.6,0,28263,28363,194728
2002,49,40761,49888,907172,908976,8120,16.5,6610,13.5,167554,73396,94158,8.1,18.4,171161,60999,110162,6.7,18.8,-3607,-0.4,36.8,0,3417,3423,26221
2002,50,16746,19238,259616,259974,2007,10.4,2113,11,40059,16271,23788,6.3,15.4,40774,14728,26046,5.7,15.7,-715,-0.3,30.8,0,1054,1055,5954
2002,51,125505,161828,2896124,2904028,20479,12.8,17918,11.2,492624,205723,286901,7.1,17,508431,186087,322344,6.4,17.5,-15807,-0.5,34,0,9028,9047,60680
2002,53,118585,145127,2189870,2216422,19997,13.8,19095,13.2,385685,184631,201054,8.3,17.4,438789,140671,298118,6.3,19.8,-53104,-2.4,34.8,0,10264,10286,61813
2002,54,29401,36976,556662,553177,4011,10.8,4070,11,92092,31516,60576,5.7,16.6,85122,30857,54265,5.6,15.4,6970,1.2,30.8,0,2194,2199,11752
2002,55,104674,129922,2364394,2377913,14305,11,13658,10.5,339783,135311,204472,5.7,14.3,366820,115170,251650,4.8,15.4,-27037,-1.1,28.6,0,6811,6830,44522
2002,56,14384,16601,176551,175962,2359,14.4,1884,11.5,33959,14311,19648,8.1,19.3,32781,13275,19506,7.5,18.6,1178,0.7,37.2,0,1017,1018,5195
2003,1,70851,91496,1589786,1570724,10134,11.2,8000,8.8,250999,90856,160143,5.8,16,212874,63236,149638,4,13.6,38125,2.4,27.2,0,5814,5816,34175
2003,2,13043,15858,219198,215050,2105,13.5,1514,9.7,40954,15101,25853,7,19,32658,9571,23087,4.5,15.2,8296,3.8,30.4,0,902,902,4882
2003,4,82623,105558,1963941,1927557,14963,14.4,10864,10.4,384601,146951,237650,7.6,20,311833,103216,208617,5.4,16.2,72768,3.8,32.4,0,7342,7361,56442
2003,5,46899,58597,984358,973437,7040,12.2,5199,9,141767,48680,93087,5,14.6,119924,34749,85175,3.6,12.3,21843,2.3,24.6,0,3787,3793,20190
2003,6,587621,729066,12942795,12777250,97733,13.5,75431,10.5,2355363,886493,1468870,6.9,18.4,2024273,668501,1355772,5.2,15.8,331090,2.6,31.6,0,51935,52630,385804
2003,8,101994,123853,1853454,1850512,17406,14.2,13470,11,318903,133326,185577,7.2,17.2,313020,109865,203155,5.9,16.9,5883,0.3,33.8,0,8713,8725,57425
2003,9,67865,82115,1547258,1541562,7819,9.5,7219,8.8,212573,61804,150769,4,13.8,201181,65759,135422,4.3,13.1,11392,0.7,26.2,0,4625,4631,27789
2003,10,17829,21928,380980,382030,2625,12.1,1968,9.1,52043,19761,32282,5.2,13.6,54142,17970,36172,4.7,14.2,-2099,-0.6,27.2,0,1294,1296,7653
2003,11,15061,18442,427817,424255,1726,9.4,1492,8.1,59203,19194,40009,4.5,14,52079,13221,38858,3.1,12.3,7124,1.7,24.6,0,896,896,6476
2003,12,319339,395027,6424149,6309067,60634,15.6,42930,11.1,1298902,529999,768903,8.4,20.6,1068739,408412,660327,6.5,16.9,230163,3.7,33.8,0,29821,29893,224388
2003,13,144153,184508,3355026,3333093,24964,13.7,18367,10.1,548237,216971,331266,6.5,16.4,504370,155600,348770,4.7,15.1,43867,1.3,30.2,0,12211,12226,78997
2003,15,22549,28114,458741,447732,3058,11,2164,7.8,71492,24052,47440,5.4,16,49473,18316,31157,4.1,11,22019,5,22,0,1484,1484,11062
2003,16,29240,34762,469002,460323,5022,14.7,3455,10.1,81168,29999,51169,6.5,17.6,63810,20505,43305,4.5,13.9,17358,3.7,27.8,0,2275,2286,11898
2003,17,223325,277879,5200259,5167493,30535,11.1,24697,9,766715,261745,504970,5.1,14.8,701183,219160,482023,4.2,13.6,65532,1.2,27.2,0,15758,15854,110956
2003,18,103738,134144,2539861,2509938,13717,10.3,11134,8.4,380154,127413,252741,5.1,15.1,320309,100712,219597,4,12.8,59845,2.3,25.6,0,7445,7516,51555
2003,19,59867,75202,1233004,1226816,7694,10.3,6528,8.7,160859,58140,102719,4.7,13.1,148482,43119,105363,3.5,12.1,12377,1,24.2,0,3993,3995,24901
2003,20,55583,69184,1107592,1095152,7716,11.2,6232,9.1,166995,69385,97610,6.3,15.2,142114,45815,96299,4.2,13,24881,2.2,26,0,4172,4183,23774
2003,21,64837,83125,1478994,1467632,8608,10.4,7077,8.6,212721,75385,137336,5.1,14.5,189996,57208,132788,3.9,12.9,22725,1.6,25.8,0,4913,4951,31907
2003,22,74085,93480,1590923,1567208,10009,10.8,7699,8.3,256446,85795,170651,5.5,16.4,209015,63021,145994,4,13.3,47431,3.1,26.6,0,5479,5486,38263
2003,23,29345,35155,483071,480139,3877,11.1,3010,8.6,68280,25439,42841,5.3,14.2,62416,20517,41899,4.3,13,5864,1.2,26,0,1941,1944,10940
2003,24,95026,117953,2079153,2051904,13660,11.7,10065,8.6,328382,118098,210284,5.8,16,273884,79688,194196,3.9,13.3,54498,2.7,26.6,0,6540,6541,41431
2003,25,128776,157526,2964325,2959626,17790,11.4,13784,8.8,424117,143619,280498,4.9,14.3,414719,136071,278648,4.6,14,9398,0.3,28,0,8842,8859,60439
2003,26,166000,209164,3851849,3838090,22340,10.7,19314,9.3,597385,221034,376351,5.8,15.6,569868,169423,400445,4.4,14.8,27517,0.8,29.6,0,12422,12541,100098
2003,27,103693,128338,2385133,2363568,14968,11.8,11264,8.9,366020,138684,227336,5.9,15.5,322889,97890,224999,4.1,13.7,43131,1.8,27.4,0,6879,6882,47603
2003,28,43335,54961,906431,897409,6362,11.7,4959,9.1,140891,52119,88772,5.8,15.7,122847,36569,86278,4.1,13.7,18044,2,27.4,0,3598,3601,23902
2003,29,106852,134388,2380477,2349715,16164,12.2,12380,9.3,355453,116589,238864,5,15.1,293930,90861,203069,3.9,12.5,61523,2.6,25,0,8530,8538,50181
2003,30,25158,29245,306645,302594,3742,13,2713,9.4,49994,20226,29768,6.7,16.5,41891,13211,28680,4.4,13.8,8103,2.7,27.6,0,1725,1726,7872
2003,31,38944,47527,763425,751239,5049,10.7,4079,8.6,118660,39490,79170,5.3,15.8,94287,26860,67427,3.6,12.6,24373,3.2,25.2,0,2567,2568,13266
2003,32,36483,45217,963621,943996,7679,17.4,4974,11.3,173864,70776,103088,7.5,18.4,134614,43350,91264,4.6,14.3,39250,4.1,28.6,0,3494,3501,23159
2003,33,28146,33672,531303,529900,3691,11,3097,9.2,75791,29201,46590,5.5,14.3,72984,22896,50088,4.3,13.8,2807,0.5,27.6,0,2086,2087,11905
2003,34,175828,208450,3558712,3542889,24636,11.9,21039,10.1,577932,208411,369521,5.9,16.3,546287,176564,369723,5,15.4,31645,0.9,30.8,0,13921,13935,91871
2003,35,31725,39053,575797,564373,4769,12.3,3668,9.5,100914,39373,61541,7,17.9,78068,27816,50252,4.9,13.8,22846,4.1,27.6,0,2396,2402,14337
2003,36,374982,442949,7361770,7285355,53034,12.1,43044,9.8,1153883,394219,759664,5.4,15.8,1001055,314783,686272,4.3,13.7,152828,2.1,27.4,0,29677,29714,180911
2003,37,146113,187490,3337992,3315807,22256,12,17064,9.2,533260,211574,321686,6.4,16.1,488889,152676,336213,4.6,14.7,44371,1.4,29.4,0,11503,11525,71464
2003,38,16405,19588,261216,257103,1992,10.2,1654,8.5,36436,11938,24498,4.6,14.2,28210,9156,19054,3.6,11,8226,3.2,22,0,958,958,5079
2003,39,187082,245380,4754725,4725776,23934,9.8,20322,8.3,687329,233137,454192,4.9,14.5,629430,179585,449845,3.8,13.3,57899,1.2,26.6,0,13218,13287,93469
2003,40,63129,78325,1174697,1174844,8890,11.4,7121,9.2,180028,61837,118191,5.3,15.3,180321,53685,126636,4.6,15.3,-293,0,30.6,0,5150,5154,31026
2003,41,75130,91437,1338528,1324580,11430,12.6,8587,9.5,214593,68467,146126,5.2,16.2,186697,62709,123988,4.7,14.1,27896,2.1,28.2,0,5743,5748,33400
2003,42,212591,270989,5060746,5030410,26531,9.8,21830,8.1,742294,254821,487473,5.1,14.8,681622,190142,491480,3.8,13.6,60672,1.2,27.2,0,14365,14429,96003
2003,44,22420,25666,420516,415883,2845,11.2,2242,8.8,62243,21015,41228,5.1,15,52976,15285,37691,3.7,12.7,9267,2.3,25.4,0,1417,1425,8228
2003,45,70240,89489,1536829,1524442,10644,12,7966,9,245629,100873,144756,6.6,16.1,220856,68558,152298,4.5,14.5,24773,1.6,29,0,5659,5664,36459
2003,46,19400,22769,297115,297959,2601,11.5,2159,9.5,42022,15161,26861,5.1,14.1,43710,18403,25307,6.2,14.7,-1688,-0.6,28.2,0,1293,1293,6429
2003,47,90285,119167,2295196,2273498,13610,11.5,10931,9.2,364617,138120,226497,6.1,16,321221,94072,227149,4.1,14.1,43396,1.9,28.2,0,7543,7555,49842
2003,48,333028,437768,7955957,7895629,56286,13,43632,10.1,1409711,561550,848161,7.1,17.9,1289056,451466,837590,5.7,16.3,120655,1.6,32.6,0,29737,29888,225714
2003,49,42122,51208,905276,899757,8158,16.2,5915,11.8,161410,71075,90335,7.9,17.9,150373,52795,97578,5.9,16.7,11037,1.2,33.4,0,3834,3841,31326
2003,50,16808,19399,257397,257178,2056,10.7,1624,8.4,36273,12766,23507,5,14.1,35834,11840,23994,4.6,13.9,439,0.2,27.8,0,1053,1054,6342
2003,51,127405,164305,2904856,2882215,19576,12.1,14201,8.8,444878,162923,281955,5.7,15.4,399597,124734,274863,4.3,13.9,45281,1.5,27.8,0,9251,9303,62553
2003,53,120225,146836,2207432,2185136,19354,13.3,14913,10.3,362841,133708,229133,6.1,16.6,318249,107815,210434,4.9,14.6,44592,2,29.2,0,9880,9897,53470
2003,54,29173,36835,555683,552985,3622,9.9,3079,8.4,78736,31773,46963,5.7,14.2,73339,19584,53755,3.5,13.3,5397,0.9,26.6,0,2109,2114,11874
2003,55,104378,129863,2385314,2362532,13013,10.1,11147,8.6,331004,115711,215293,4.9,14,285440,82755,202685,3.5,12.1,45564,1.9,24.2,0,7241,7266,44940
2003,56,14524,16728,177372,175525,2085,12.6,1679,10.1,29554,10311,19243,5.9,16.8,25860,8580,17280,4.9,14.7,3694,2.1,29.4,0,1100,1105,5125
2004,1,71472,92076,1614985,1595635,9802,10.7,8305,9.1,254567,85316,169251,5.3,16,215866,74895,140971,4.7,13.5,38701,2.5,27,0,5601,5616,35570
2004,2,13250,16086,223045,219711,2038,12.8,1603,10.1,35772,10870,24902,4.9,16.3,29104,10058,19046,4.6,13.2,6668,3.1,26.4,0,969,969,5022
2004,4,84744,108098,2014506,1979836,14883,14,10954,10.3,366528,132717,233811,6.7,18.5,297187,104523,192664,5.3,15,69341,3.5,30,0,7166,7181,56727
2004,5,47421,59194,996269,984730,6561,11.2,5450,9.3,142773,46484,96289,4.7,14.5,119696,37911,81785,3.8,12.2,23077,2.3,24.4,0,3840,3846,21139
2004,6,593662,734959,13121706,12966279,93293,12.8,78283,10.7,2283754,854444,1429310,6.6,17.6,1972902,711318,1261584,5.5,15.2,310852,2.4,30.4,0,52673,52787,393618
2004,8,103741,125873,1883677,1861209,16929,13.6,13541,10.9,318825,132411,186414,7.1,17.1,273889,95157,178732,5.1,14.7,44936,2.4,29.4,0,8644,8666,50772
2004,9,68276,82751,1523726,1529858,8153,9.9,6806,8.3,191361,63075,128286,4.1,12.5,203626,74234,129392,4.9,13.3,-12265,-0.8,25,0,4383,4394,36724
2004,10,18191,22430,386721,383798,2692,12.2,1995,9,56286,20533,35753,5.3,14.7,50440,17943,32497,4.7,13.1,5846,1.6,26.2,0,1262,1269,7078
2004,11,14654,18123,438409,432001,1408,7.7,1549,8.5,58817,17728,41089,4.1,13.6,46000,13427,32573,3.1,10.6,12817,3,21.2,0,903,908,6221
2004,12,335082,411584,6506507,6441656,66259,16.5,45149,11.2,1261362,474346,787016,7.4,19.6,1131660,491242,640418,7.6,17.6,129702,2,35.2,0,30760,30972,209471
2004,13,147807,188399,3426683,3371720,24424,13.1,18318,9.9,584601,212014,372587,6.3,17.3,474674,162093,312581,4.8,14.1,109927,3.2,28.2,0,12038,12077,79149
2004,15,22934,28624,472609,464861,3022,10.7,2282,8.1,66361,22529,43832,4.8,14.3,50865,16463,34402,3.5,10.9,15496,3.4,21.8,0,1523,1523,9534
2004,16,30217,35804,489523,476944,4931,14,3546,10.1,88800,41657,47143,8.7,18.6,63641,22442,41199,4.7,13.3,25159,5.3,26.6,0,2212,2220,10679
2004,17,225492,279849,5218914,5188313,29948,10.8,25337,9.1,751333,244870,506463,4.7,14.5,690131,216284,473847,4.2,13.3,61202,1.2,26.6,0,15568,15661,107085
2004,18,104496,135302,2579024,2550731,13602,10.1,11173,8.3,361121,120418,240703,4.7,14.2,304536,98355,206181,3.9,11.9,56585,2.3,23.8,0,7405,7412,50205
2004,19,60175,75499,1241072,1232704,7324,9.7,6461,8.6,160629,50908,109721,4.1,13,143892,47957,95935,3.9,11.7,16737,1.3,23.4,0,3979,3988,20807
2004,20,56111,69689,1108861,1106295,7387,10.7,6205,9,150365,56055,94310,5.1,13.6,145234,46531,98703,4.2,13.1,5131,0.5,26.2,0,3984,3986,23693
2004,21,65272,83606,1490621,1472814,8529,10.3,7224,8.7,217757,78049,139708,5.3,14.8,182145,62239,119906,4.2,12.4,35612,2.4,24.8,0,4801,4807,32250
2004,22,74872,94266,1605290,1593575,9589,10.2,7960,8.5,243480,75969,167511,4.8,15.3,220050,71964,148086,4.5,13.8,23430,1.5,27.6,0,5385,5402,38765
2004,23,29655,35514,486213,483027,3803,10.8,3125,8.9,61788,20149,41639,4.2,12.8,55415,19788,35627,4.1,11.5,6373,1.3,23,0,2053,2068,10996
2004,24,97042,120105,2133588,2099910,13613,11.5,10399,8.8,333718,113586,220132,5.4,15.9,266364,92377,173987,4.4,12.7,67354,3.2,25.4,0,6613,6630,47521
2004,25,127199,155943,2967745,2958283,15956,10.2,16251,10.4,393905,137251,256654,4.6,13.3,374982,119053,255929,4,12.7,18923,0.6,25.4,0,11467,11492,57027
2004,26,166312,208771,3852113,3836368,21477,10.3,19636,9.4,561765,207113,354652,5.4,14.6,530276,177279,352997,4.6,13.8,31489,0.8,27.6,0,12123,12192,89336
2004,27,105312,130217,2385168,2378766,14685,11.4,11483,8.9,321341,108877,212464,4.6,13.5,308537,105124,203413,4.4,13,12804,0.5,26,0,6926,6941,48391
2004,28,43684,55433,924322,912968,5967,10.8,5015,9.1,140085,53303,86782,5.8,15.3,117376,40990,76386,4.5,12.9,22709,2.4,25.8,0,3452,3463,19651
2004,29,109006,136681,2397229,2378970,16510,12.2,12905,9.5,351927,126097,225830,5.3,14.8,315410,109887,205523,4.6,13.3,36517,1.5,26.6,0,8767,8770,53543
2004,30,25860,29969,314165,308861,3922,13.3,2896,9.8,49485,17337,32148,5.6,16,38877,15548,23329,5,12.6,10608,3.4,25.2,0,1779,1780,8329
2004,31,39246,47845,776820,767628,4842,10.2,4069,8.5,99767,35674,64093,4.6,13,81385,24188,57197,3.2,10.6,18382,2.4,21.2,0,2548,2569,13055
2004,32,38127,47081,1014839,984966,7764,16.9,5313,11.5,190407,71225,119182,7.2,19.3,130660,49168,81492,5,13.3,59747,6,26.6,0,3612,3631,26635
2004,33,28611,34208,537946,533352,3799,11.2,2984,8.8,68822,22707,46115,4.3,12.9,59634,20873,38761,3.9,11.2,9188,1.7,22.4,0,2016,2033,12487
2004,34,177753,209313,3587933,3552143,24194,11.6,21568,10.3,564595,183012,381583,5.2,15.9,493016,167338,325678,4.7,13.9,71579,2,27.8,0,13823,13854,83471
2004,35,32197,39558,581642,575273,4589,11.7,3670,9.4,94583,34548,60035,6,16.4,81845,29633,52212,5.2,14.2,12738,2.2,28.4,0,2396,2396,14283
2004,36,379259,447633,7399187,7355648,53352,12,45393,10.2,1093368,370567,722801,5,14.9,1006290,325069,681221,4.4,13.7,87078,1.2,27.4,0,30426,30488,181631
2004,37,148686,190196,3344394,3323012,21708,11.5,16984,9,500110,170143,329967,5.1,15,457346,149206,308140,4.5,13.8,42764,1.2,27.6,0,11195,11235,73486
2004,38,16643,19818,265173,262250,2066,10.5,1660,8.4,34101,10818,23283,4.1,13,28254,11908,16346,4.5,10.8,5847,2.2,21.6,0,978,978,5025
2004,39,187128,245855,4740383,4727988,23420,9.6,20469,8.4,628545,212354,416191,4.5,13.3,603757,201670,402087,4.3,12.8,24788,0.5,25.6,0,13121,13172,104705
2004,40,63822,79148,1184369,1173995,8688,11.1,7120,9.1,183129,65997,117132,5.6,15.6,162380,50470,111910,4.3,13.8,20749,1.8,27.6,0,4870,4904,27927
2004,41,76359,92963,1351840,1340514,11300,12.3,8927,9.7,199400,73672,125728,5.5,14.9,176748,66541,110207,5,13.2,22652,1.7,26.4,0,5862,5872,31963
2004,42,214424,272869,5087695,5058490,26174,9.6,22035,8.1,700298,227142,473156,4.5,13.8,641889,233880,408009,4.6,12.7,58409,1.1,25.4,0,14137,14155,115385
2004,44,22961,26311,432530,425280,2945,11.3,2141,8.2,61770,19563,42207,4.6,14.5,47270,15516,31754,3.6,11.1,14500,3.4,22.2,0,1452,1453,8991
2004,45,71410,90864,1539707,1531314,10400,11.6,8100,9,229062,85624,143438,5.6,15,212277,70366,141911,4.6,13.9,16785,1.1,27.8,0,5527,5528,36224
2004,46,19675,23064,304498,299844,2550,11.1,2067,9,45170,14461,30709,4.8,15.1,35861,13442,22419,4.5,12,9309,3.1,24,0,1326,1326,6635
2004,47,91498,120551,2336901,2306411,13254,11.1,10629,8.9,353759,124659,229100,5.4,15.3,292779,99635,193144,4.3,12.7,60980,2.6,25.4,0,7136,7153,49940
2004,48,336923,442722,8041430,7962869,54653,12.4,44588,10.2,1382956,555963,826993,7,17.4,1225833,434284,791549,5.5,15.4,157123,2,30.8,0,29897,29985,217267
2004,49,43681,52884,942176,917810,8019,15.4,5735,11,175859,64231,111628,7,19.2,127127,44436,82691,4.8,13.9,48732,5.3,27.8,0,3688,3689,23792
2004,50,17025,19607,255153,255415,1941,10,1579,8.1,28673,10194,18479,4,11.2,29196,8729,20467,3.4,11.4,-523,-0.2,22.4,0,1012,1012,5250
2004,51,131178,168554,3016098,2949768,19923,12,14036,8.5,493890,170558,323332,5.8,16.7,361230,114816,246414,3.9,12.2,132660,4.5,24.4,0,9026,9045,59579
2004,53,122404,149486,2264413,2229661,19050,12.9,14918,10.1,362093,133202,228891,6,16.2,292589,94297,198292,4.2,13.1,69504,3.1,26.2,0,9806,9813,52630
2004,54,29372,37107,561307,556092,3632,9.8,3029,8.2,75233,23602,51631,4.2,13.5,64803,19512,45291,3.5,11.7,10430,1.8,23.4,0,2074,2092,11248
2004,55,105332,131164,2435945,2402910,12796,9.8,10444,8,330386,113316,217070,4.7,13.7,264315,85672,178643,3.6,11,66071,2.7,22,0,6738,6774,43249
2004,56,14794,17032,184821,180648,2055,12.2,1611,9.6,30990,10537,20453,5.8,17.2,22644,7768,14876,4.3,12.5,8346,4.7,25,0,1027,1027,4538
2005,1,72379,93582,1662638,1634564,10222,11,7906,8.5,274592,95164,179428,5.8,16.8,218443,64909,153534,4,13.4,56149,3.4,26.8,0,5633,5650,37941
2005,2,13497,16460,229854,226152,1996,12.3,1493,9.2,36057,11163,24894,4.9,15.9,28652,7271,21381,3.2,12.7,7405,3.2,25.4,0,959,959,4609
2005,4,88211,112999,2142596,2072492,16613,15.1,10492,9.5,424522,175465,249057,8.5,20.5,284314,96815,187499,4.7,13.7,140208,6.8,27.4,0,7241,7245,54418
2005,5,47865,60165,1015476,1004064,6791,11.4,5359,9,143414,52922,90492,5.3,14.3,120591,38122,82469,3.8,12,22823,2.3,24,0,3993,3999,24541
2005,6,607959,754584,13345295,13189790,101660,13.7,75097,10.1,2284137,885579,1398558,6.7,17.3,1973127,663768,1309359,5,15,311010,2.3,30,0,53087,53235,394008
2005,8,106720,129645,1918924,1894746,18260,14.3,13274,10.4,319157,132179,186978,7,16.8,270800,100132,170668,5.3,14.3,48357,2.5,28.6,0,8759,8791,61113
2005,9,68897,83702,1522581,1519324,8674,10.4,7118,8.6,212653,95076,117577,6.3,14,206140,75916,130224,5,13.6,6513,0.4,27.2,0,4603,4606,35213
2005,10,18412,22551,390011,387945,2519,11.2,2180,9.7,56603,20856,35747,5.4,14.6,52471,21952,30519,5.7,13.5,4132,1.1,27,0,1290,1293,9935
2005,11,15389,18993,445775,440841,2433,13.2,1399,7.6,59025,22484,36541,5.1,13.4,49157,12369,36788,2.8,11.2,9868,2.2,22.4,0,770,776,4999
2005,12,351039,431262,6738527,6602777,69166,16.4,45285,10.8,1315310,569327,745983,8.6,19.9,1043811,393772,650039,6,15.8,271499,4.1,31.6,0,31706,31817,249281
2005,13,152076,194043,3490235,3443976,25968,13.6,18506,9.7,582227,223553,358674,6.5,16.9,489709,164371,325338,4.8,14.2,92518,2.7,28.4,0,12591,12604,95806
2005,15,23410,29293,488435,479738,3053,10.6,2179,7.5,73803,29715,44088,6.2,15.4,56409,18410,37999,3.8,11.8,17394,3.6,23.6,0,1500,1525,11906
2005,16,31918,37708,517603,502353,5605,15.3,3385,9.2,96755,41205,55550,8.2,19.3,66255,26053,40202,5.2,13.2,30500,6.1,26.4,0,2272,2274,13470
2005,17,228443,283960,5233025,5213059,32069,11.4,25366,9,739683,282276,457407,5.4,14.2,699752,217683,482069,4.2,13.4,39931,0.8,26.8,0,16165,16209,120288
2005,18,105023,136395,2605549,2585082,13745,10.1,11470,8.5,356364,135958,220406,5.3,13.8,315430,95555,219875,3.7,12.2,40934,1.6,24.4,0,7770,7806,58297
2005,19,60885,76433,1259275,1246786,7579,10,6122,8.1,157595,53540,104055,4.3,12.6,132616,39847,92769,3.2,10.6,24979,2,21.2,0,4094,4114,24081
2005,20,56845,70649,1122574,1112978,7564,10.8,5932,8.5,161527,60315,101212,5.4,14.5,142335,49672,92663,4.5,12.8,19192,1.7,25.6,0,4101,4112,23195
2005,21,65887,84637,1510276,1496833,8872,10.6,7152,8.5,219566,76883,142683,5.1,14.7,192680,54904,137776,3.7,12.9,26886,1.8,25.8,0,5068,5089,34429
2005,22,74934,94706,1598575,1594129,9567,10.1,8099,8.6,247895,87474,160421,5.5,15.6,239003,82180,156823,5.2,15,8892,0.6,30,0,5753,5774,47327
2005,23,30154,36158,491419,487749,3972,11.1,3077,8.6,63475,23052,40423,4.7,13,56134,16440,39694,3.4,11.5,7341,1.5,23,0,2039,2041,10078
2005,24,99167,122732,2149557,2136665,14400,11.9,10728,8.9,311480,116527,194953,5.5,14.6,285696,92350,193346,4.3,13.4,25784,1.2,26.8,0,6933,6957,47501
2005,25,126998,156377,2984718,2966024,16216,10.4,14554,9.3,390335,142422,247913,4.8,13.2,352948,114611,238337,3.9,11.9,37387,1.3,23.8,0,10017,10039,59286
2005,26,167098,209974,3751241,3790426,22196,10.6,19213,9.2,511793,205032,306761,5.4,13.5,590163,164443,425720,4.3,15.6,-78370,-2.1,27,0,12549,12618,99079
2005,27,107118,132475,2433767,2402852,14683,11.2,11384,8.7,344420,130870,213550,5.4,14.3,282590,86195,196395,3.6,11.8,61830,2.5,23.6,0,7210,7216,47352
2005,28,43735,55817,923620,920135,6098,11,5091,9.2,132239,51313,80926,5.6,14.4,125269,39094,86175,4.2,13.6,6970,0.8,27.2,0,3639,3652,24579
2005,29,111220,139776,2407476,2396183,17137,12.4,12874,9.3,333477,135347,198130,5.6,13.9,310890,95608,215282,4,13,22587,0.9,26,0,9179,9191,63080
2005,30,26732,30943,323103,317959,4012,13.2,2781,9.1,49135,19836,29299,6.2,15.5,38847,11797,27050,3.7,12.2,10288,3.3,24.4,0,1866,1872,7805
2005,31,39748,48496,778025,774848,4959,10.3,3892,8.1,108711,36342,72369,4.7,14,102357,26556,75801,3.4,13.2,6354,0.8,26.4,0,2610,2620,15951
2005,32,40052,49512,1076167,1043120,8348,17.3,5402,11.2,208973,81708,127265,7.8,20,142879,61899,80980,5.9,13.7,66094,6.3,27.4,0,3883,3885,35401
2005,33,29033,34859,548851,542073,3961,11.5,3059,8.9,73999,30510,43489,5.6,13.7,60442,20052,40390,3.7,11.2,13557,2.5,22.4,0,2149,2150,13090
2005,34,180197,212323,3554189,3555043,25620,12.2,21044,10,515728,196775,318953,5.5,14.5,517436,181597,335839,5.1,14.6,-1708,-0.1,29,0,14401,14413,95687
2005,35,32760,40381,597324,587591,4742,11.9,3561,8.9,101294,37031,64263,6.3,17.2,81827,24355,57472,4.1,13.9,19467,3.3,27.8,0,2442,2452,15439
2005,36,385002,452487,7407894,7381471,53492,11.9,45682,10.2,1062992,422614,640378,5.7,14.4,1010146,340576,669570,4.6,13.7,52846,0.7,27.4,0,31107,31147,198241
2005,37,152360,194900,3405691,3363790,23505,12.2,17049,8.9,537695,214211,323484,6.4,16,453892,136291,317601,4.1,13.5,83803,2.5,27,0,11751,11790,78343
2005,38,16939,20222,272801,268540,2248,11.2,1731,8.7,38257,14559,23698,5.4,14.2,29735,10766,18969,4,11.1,8522,3.1,22.2,0,1018,1018,4622
2005,39,187383,247000,4747126,4728957,23713,9.6,20549,8.4,666967,249049,417918,5.3,14.1,630628,193673,436955,4.1,13.3,36339,0.8,26.6,0,13565,13598,108655
2005,40,64701,80552,1208338,1194796,9265,11.6,7139,9,187725,74852,112873,6.3,15.7,160641,57733,102908,4.8,13.4,27084,2.3,26.8,0,5099,5108,35958
2005,41,79051,96122,1410850,1376850,12623,13.4,8703,9.2,229515,91989,137526,6.7,16.7,161516,58406,103110,4.2,11.7,67999,5,23.4,0,5840,5845,34330
2005,42,216478,276216,5074894,5066895,28010,10.2,22600,8.3,674162,262746,411416,5.2,13.3,658165,215599,442566,4.3,13,15997,0.3,26,0,14988,15035,110429
2005,44,23171,26683,436462,433270,2924,11.1,2400,9.1,55840,21982,33858,5.1,12.9,49455,14858,34597,3.4,11.4,6385,1.5,22.8,0,1628,1628,9956
2005,45,73226,93427,1574943,1552413,11343,12.3,8031,8.7,241269,94634,146635,6.1,15.5,196208,56911,139297,3.7,12.6,45061,2.9,25.2,0,5742,5755,35571
2005,46,20129,23578,310694,306607,2668,11.5,1987,8.5,43260,14299,28961,4.7,14.1,35085,10814,24271,3.5,11.4,8175,2.7,22.8,0,1284,1284,5874
2005,47,92605,122437,2368103,2344684,13828,11.4,10803,8.9,356630,127907,228723,5.5,15.2,309793,93411,216382,4,13.2,46837,2,26.4,0,7580,7593,54101
2005,48,342628,452198,8229396,8110052,56918,12.8,42870,9.6,1413485,585411,828074,7.2,17.4,1174796,394941,779855,4.9,14.5,238689,2.9,29,0,29988,30107,242072
2005,49,45788,55293,973881,954874,8686,16.1,5754,10.7,180597,68628,111969,7.2,18.9,142584,49688,92896,5.2,14.9,38013,4,29.8,0,3799,3809,28660
2005,50,17155,19781,260795,257360,1954,9.9,1662,8.4,35686,11691,23995,4.5,13.9,28815,9795,19020,3.8,11.2,6871,2.7,22.4,0,1116,1119,6109
2005,51,134723,172936,3049113,3021887,20763,12.2,14743,8.7,458993,177070,281923,5.9,15.2,404542,112834,291708,3.7,13.4,54451,1.8,26.8,0,9767,9818,57909
2005,53,126434,154340,2319079,2285114,21072,13.9,14876,9.8,374235,143018,231217,6.3,16.4,306304,108309,197995,4.7,13.4,67931,3,26.8,0,10053,10058,60825
2005,54,29504,37438,563940,561460,3881,10.4,3213,8.6,77374,27087,50287,4.8,13.8,72413,21077,51336,3.8,12.9,4961,0.9,25.8,0,2229,2233,11332
2005,55,106792,133178,2455496,2440115,13460,10.2,10567,8,320512,111162,209350,4.6,13.1,289749,90230,199519,3.7,11.9,30763,1.2,23.8,0,7168,7207,48998
2005,56,15202,17566,189389,187257,2222,12.9,1575,9.1,30626,11390,19236,6.1,16.4,26361,8058,18303,4.3,14.1,4265,2.3,28.2,0,1091,1091,5478
2006,1,72378,94558,1705731,1680332,10525,11.2,8639,9.2,273784,109437,164347,6.5,16.3,222986,80288,142698,4.8,13.3,50798,3,26.6,0,5973,5998,42474
2006,2,13535,16710,239035,233636,2140,12.9,1741,10.5,41439,12152,29287,5.2,17.7,30641,10348,20293,4.4,13.1,10798,4.6,26.2,0,1076,1076,5623
2006,4,92548,119491,2319175,2225682,18968,16.4,11487,9.9,458328,180441,277887,8.1,20.6,271342,93301,178041,4.2,12.2,186986,8.4,24.4,0,7803,7828,54808
2006,5,47771,60853,1043837,1026745,7145,11.8,5873,9.7,151364,58159,93205,5.7,14.7,117180,38471,78709,3.7,11.4,34184,3.3,22.8,0,4225,4241,25745
2006,6,619826,773397,13776263,13522011,105552,13.8,80469,10.6,2429653,937353,1492300,6.9,18,1921149,665962,1255187,4.9,14.2,508504,3.8,28.4,0,56411,56571,416621
2006,8,108706,132720,1998274,1952083,18771,14.3,14373,11,354010,143494,210516,7.4,18.1,261627,99192,162435,5.1,13.4,92383,4.7,26.8,0,9398,9416,61477
2006,9,68549,83967,1549305,1531995,8621,10.3,7735,9.2,210602,76436,134166,5,13.7,175981,59820,116161,3.9,11.5,34621,2.2,23,0,5321,5323,35682
2006,10,18230,22481,382984,385547,2568,11.4,2425,10.8,56283,21048,35235,5.5,14.6,61409,24771,36638,6.4,15.9,-5126,-1.3,29.2,0,1502,1518,9579
2006,11,15597,19370,462203,452498,2078,10.9,1528,8,76655,30745,45910,6.8,16.9,57244,14990,42254,3.3,12.7,19411,4.2,25.4,0,889,895,7120
2006,12,361825,445275,7160848,6935356,67911,15.5,49504,11.3,1382205,513257,868948,7.4,19.9,931221,361109,570112,5.2,13.4,450984,6.5,26.8,0,34584,34644,220642
2006,13,155424,198955,3605702,3537652,26616,13.6,19962,10.2,622483,248884,373599,7,17.6,486383,174898,311485,4.9,13.7,136100,3.9,27.4,0,13282,13298,99550
2006,15,23802,30100,510712,498668,3308,11.2,2269,7.7,77899,29050,48849,5.8,15.6,53811,17846,35965,3.6,10.8,24088,4.8,21.6,0,1551,1551,10497
2006,16,33661,39757,546628,530824,6284,16.2,4036,10.4,99864,37708,62156,7.1,18.8,68256,28029,40227,5.3,12.9,31608,5.9,25.8,0,2648,2650,19241
2006,17,229490,286788,5351891,5280578,32291,11.3,27034,9.5,812855,301530,511325,5.7,15.4,670230,247941,422289,4.7,12.7,142625,2.7,25.4,0,17116,17147,134846
2006,18,105247,137867,2664862,2629328,14731,10.8,12217,8.9,384664,142210,242454,5.4,14.6,313597,102822,210775,3.9,11.9,71067,2.7,23.8,0,7850,7883,60893
2006,19,60253,76856,1294238,1275271,8292,10.8,7165,9.4,173639,66500,107139,5.2,13.6,135705,43574,92131,3.4,10.6,37934,3,21.2,0,4371,4371,27961
2006,20,56415,70720,1137920,1126319,7614,10.8,6900,9.8,162473,59367,103106,5.3,14.4,139271,45885,93386,4.1,12.4,23202,2,24.8,0,4385,4408,27004
2006,21,65752,85288,1539891,1519692,8965,10.6,7661,9,226759,81656,145103,5.4,14.9,186361,65207,121154,4.3,12.3,40398,2.6,24.6,0,5285,5289,41320
2006,22,71358,91374,1568977,1575338,9987,10.8,11701,12.6,274847,99276,175571,6.3,17.4,287569,95913,191656,6.1,18.3,-12722,-0.9,34.8,0,7363,7369,52140
2006,23,30272,36572,500288,494329,4261,11.7,3563,9.8,70379,30556,39823,6.2,14.2,58460,21882,36578,4.4,11.8,11919,2.4,23.6,0,2437,2442,14180
2006,24,100323,124939,2218543,2179628,14742,11.9,11467,9.3,350457,128296,222161,5.9,16.1,272628,97574,175054,4.5,12.5,77829,3.6,25,0,7580,7597,51737
2006,25,127633,158077,3053152,3011546,16962,10.8,13999,8.9,448860,167390,281470,5.6,14.9,365648,122554,243094,4.1,12.1,83212,2.8,24.2,0,9352,9359,67178
2006,26,165733,210086,3778480,3752759,22045,10.5,20294,9.7,549574,198322,351252,5.3,14.6,498132,156931,341201,4.2,13.3,51442,1.3,26.6,0,13569,13605,91924
2006,27,107626,134342,2484631,2452735,15651,11.8,12584,9.5,359352,130876,228476,5.3,14.7,295560,102614,192946,4.2,12.1,63792,2.6,24.2,0,7834,7843,57730
2006,28,42945,55315,937352,927943,6193,11.2,6036,10.9,147220,56797,90423,6.1,15.9,128401,42506,85895,4.6,13.8,18819,2.1,27.6,0,4004,4009,25880
2006,29,109349,139320,2447204,2420544,16360,11.7,15528,11.2,363775,139816,223959,5.8,15,310454,108761,201693,4.5,12.8,53321,2.2,25.6,0,10783,10827,64489
2006,30,27558,31966,336865,329119,4468,14.2,3197,10.2,58353,23583,34770,7.2,17.7,42861,16951,25910,5.2,13,15492,4.7,26,0,2069,2069,11752
2006,31,39545,48717,794001,783708,5134,10.6,4516,9.3,109578,43737,65841,5.6,14,88994,28349,60645,3.6,11.4,20584,2.6,22.8,0,2758,2765,17144
2006,32,41878,52135,1155713,1113286,8939,17.6,5869,11.6,229969,92869,137100,8.3,20.7,145115,52088,93027,4.7,13,84854,7.7,26,0,4181,4184,33637
2006,33,29024,35101,562809,554198,3946,11.3,3403,9.7,85830,32271,53559,5.8,15.5,68608,24225,44383,4.4,12.4,17222,3.1,24.8,0,2353,2354,14508
2006,34,181012,214178,3605373,3568553,25570,12,21931,10.3,552655,209767,342888,5.9,15.5,479015,166398,312617,4.7,13.4,73640,2.1,26.8,0,15474,15488,89799
2006,35,33207,41144,627376,610416,5098,12.5,3973,9.8,112586,42505,70081,7,18.4,78667,31285,47382,5.1,12.9,33919,5.5,25.8,0,2672,2677,20644
2006,36,385711,455839,7502273,7437022,54082,11.9,47307,10.4,1088571,400964,687607,5.4,14.6,958068,341890,616178,4.6,12.9,130503,1.7,25.8,0,34389,34435,219983
2006,37,154447,199186,3522108,3453449,24465,12.4,18435,9.4,573300,222816,350484,6.5,16.6,435982,153990,281992,4.5,12.6,137318,4,25.2,0,12625,12648,86536
2006,38,16918,20357,280566,275954,2317,11.4,1975,9.8,40005,14725,25280,5.3,14.5,30782,11272,19510,4.1,11.2,9223,3.3,22.4,0,1123,1123,6780
2006,39,185351,246599,4800932,4758087,24194,9.8,22357,9.1,679103,254661,424442,5.4,14.3,593414,208705,384709,4.4,12.5,85689,1.8,25,0,14399,14478,114524
2006,40,64943,81365,1276780,1237564,9373,11.6,7746,9.6,226585,91478,135107,7.4,18.3,148154,54896,93258,4.4,12,78431,6.3,24,0,5281,5311,32860
2006,41,80505,98541,1457043,1430798,12880,13.3,9593,9.9,234123,87908,146215,6.1,16.4,181632,63830,117802,4.5,12.7,52491,3.7,25.4,0,6592,6592,43376
2006,42,215187,277363,5158243,5103182,27645,10,24148,8.7,702984,266705,436279,5.2,13.8,592861,209539,383322,4.1,11.6,110123,2.2,23.2,0,16260,16433,130585
2006,44,23305,26980,436803,435367,3072,11.5,2544,9.5,60910,23569,37341,5.4,14,58037,16991,41046,3.9,13.3,2873,0.7,26.6,0,1734,1739,9472
2006,45,74153,95113,1624962,1595052,11337,12.1,8826,9.4,254875,97412,157463,6.1,16,195055,66164,128891,4.1,12.2,59820,3.8,24.4,0,6055,6065,40800
2006,46,20103,23665,321182,315309,2724,11.5,2418,10.3,45943,16506,29437,5.2,14.6,34196,12072,22124,3.8,10.8,11747,3.8,21.6,0,1481,1482,8041
2006,47,92964,123916,2464446,2410151,14325,11.7,11709,9.5,390718,148012,242706,6.1,16.2,282129,93816,188313,3.9,11.7,108589,4.5,23.4,0,7718,7745,50940
2006,48,345771,460608,8583203,8375935,58489,12.8,45677,10,1531731,587692,944039,7,18.3,1117195,411740,705455,4.9,13.3,414536,5,26.6,0,30709,30808,235322
2006,49,48127,58235,1034688,1001790,9529,16.8,6042,10.7,190746,73902,116844,7.4,19,124950,46872,78078,4.7,12.5,65796,6.5,25,0,4077,4119,28832
2006,50,17129,19864,262680,261260,2026,10.2,1821,9.2,32032,11134,20898,4.3,12.3,29192,9521,19671,3.6,11.2,2840,1.1,22.4,0,1237,1243,6508
2006,51,137083,177316,3154500,3089714,21981,12.6,15994,9.2,514467,185528,328939,6,16.7,384895,127366,257529,4.1,12.5,129572,4.2,25,0,10769,10783,69078
2006,53,128914,158022,2411464,2359512,21452,13.8,16430,10.5,410372,149339,261033,6.3,17.4,306467,104556,201911,4.4,13,103905,4.4,26,0,11048,11053,64929
2006,54,29036,37210,579985,570576,3717,10,3583,9.6,87186,32738,54448,5.7,15.3,68367,23281,45086,4.1,12,18819,3.3,24,0,2373,2380,13899
2006,55,106121,133644,2478851,2459800,13796,10.4,12193,9.2,327202,121659,205543,4.9,13.3,289099,89925,199174,3.7,11.8,38103,1.5,23.6,0,7959,7965,56194
2006,56,15488,17904,202018,195087,2346,13.2,1843,10.4,37671,14867,22804,7.6,19.3,23808,9119,14689,4.7,12.2,13863,7.1,24.4,0,1189,1193,6313
2007,1,73622,96908,1721599,1709888,11139,11.6,8781,9.2,276823,104465,172358,6.1,16.2,253400,81709,171691,4.8,14.8,23423,1.4,29.6,0,5675,5764,37249
2007,2,13679,16955,241991,240382,2044,12.2,1850,11,44809,16145,28664,6.7,18.6,41591,11164,30427,4.6,17.3,3218,1.3,34.6,0,1041,1052,4988
2007,4,95570,123963,2377639,2343505,18140,14.9,13421,11,470107,167423,302684,7.1,20.1,401838,133461,268377,5.7,17.1,68269,3,34.2,0,8386,8454,63839
2007,5,48160,61793,1032866,1035765,6856,11.2,5783,9.4,152237,55852,96385,5.4,14.7,158036,46611,111425,4.5,15.3,-5799,-0.6,29.4,0,3869,3889,22733
2007,6,629815,785838,13825745,13771782,102057,13.1,86930,11.2,2358964,855778,1503186,6.2,17.1,2251037,764986,1486051,5.6,16.3,107927,0.8,32.6,0,55507,56102,364910
2007,8,111058,136059,2041340,2014665,18782,14,15180,11.3,374478,147293,227185,7.3,18.6,321128,113149,207979,5.6,15.9,53350,2.7,31.8,0,9255,9318,57072
2007,9,68296,84260,1537920,1541864,8391,10,7890,9.4,225991,83355,142636,5.4,14.7,233879,65578,168301,4.3,15.2,-7888,-0.5,29.4,0,4913,4965,30142
2007,10,18094,22696,383400,382590,2705,12,2437,10.8,69066,31271,37795,8.2,18.1,67445,25341,42104,6.6,17.6,1621,0.5,35.2,0,1405,1407,9818
2007,11,15717,19682,467489,464186,2152,11,1784,9.2,75735,23473,52262,5.1,16.3,69129,19342,49787,4.2,14.9,6606,1.4,29.8,0,940,944,7356
2007,12,366713,453877,7121371,7126874,65613,14.6,55861,12.4,1274953,514753,760200,7.2,17.9,1285959,456334,829625,6.4,18,-11006,-0.1,35.8,0,37631,37914,213979
2007,13,159294,204766,3650038,3620675,27372,13.6,21213,10.5,617864,234893,382971,6.5,17.1,559139,185941,373198,5.1,15.4,58725,1.7,30.8,0,13470,13684,87229
2007,15,24138,30460,517909,513605,3187,10.5,2829,9.4,82554,28626,53928,5.6,16.1,73945,29454,44491,5.7,14.4,8609,1.7,28.8,0,1651,1672,14303
2007,16,35124,41575,549988,547752,6150,15.1,4323,10.6,102390,40862,61528,7.5,18.7,97918,32028,65890,5.8,17.9,4472,0.8,35.8,0,2813,2826,18931
2007,17,231257,290152,5369969,5353764,31715,11,27940,9.7,816725,280500,536225,5.2,15.3,784315,252775,531540,4.7,14.6,32410,0.7,29.2,0,16606,16774,120468
2007,18,105730,139328,2644249,2648387,14578,10.5,12915,9.3,391295,136682,254613,5.2,14.8,399571,120364,279207,4.5,15.1,-8276,-0.3,29.6,0,7954,8056,56304
2007,19,60685,77543,1298295,1294959,7436,9.6,6727,8.7,173519,56037,117482,4.3,13.4,166847,50774,116073,3.9,12.9,6672,0.5,25.8,0,4008,4050,23383
2007,20,56763,71384,1153823,1142704,7570,10.7,6831,9.6,174709,67684,107025,5.9,15.3,152471,48870,103601,4.3,13.3,22238,2,26.6,0,4172,4214,24391
2007,21,65914,86052,1543555,1538453,8898,10.4,7892,9.2,235863,87327,148536,5.7,15.3,225658,64110,161548,4.2,14.7,10205,0.6,29.4,0,5032,5082,34151
2007,22,74606,95335,1634563,1599345,11648,12.5,7986,8.6,299558,102029,197529,6.4,18.7,229122,67458,161664,4.2,14.3,70436,4.4,28.6,0,4954,5003,34457
2007,23,30432,37017,498387,498451,4086,11.1,3647,9.9,73449,28870,44579,5.8,14.7,73577,27168,46409,5.5,14.8,-128,-0.1,29.4,0,2235,2244,13912
2007,24,101057,126249,2214149,2211873,14165,11.3,12562,10,337923,120087,217836,5.4,15.3,333372,104104,229268,4.7,15.1,4551,0.2,30.2,0,7596,7659,46276
2007,25,127513,158516,3067167,3059158,15925,10.1,15270,9.7,429488,131522,297966,4.3,14,413471,128361,285110,4.2,13.5,16017,0.5,27,0,9121,9231,54938
2007,26,164310,209318,3670183,3714245,21426,10.2,21844,10.4,523141,188794,334347,5.1,14.1,611264,204255,407009,5.5,16.5,-88123,-2.4,28.2,0,13473,13705,88593
2007,27,107875,134931,2538645,2507080,14569,10.8,13772,10.2,398592,136034,262558,5.4,15.9,335463,112261,223202,4.5,13.4,63129,2.5,26.8,0,7660,7715,51020
2007,28,43900,56802,937817,936388,6581,11.7,5218,9.3,140097,48639,91458,5.2,15,137239,41228,96011,4.4,14.7,2858,0.3,29.4,0,3397,3420,19205
2007,29,109375,140422,2461318,2449716,15704,11.2,14317,10.3,366215,127611,238604,5.2,14.9,343011,105215,237796,4.3,14,23204,0.9,28,0,9384,9500,52710
2007,30,28420,32991,352997,344754,4224,13,3180,9.8,65190,27468,37722,8,18.9,48703,15880,32823,4.6,14.1,16487,4.8,28.2,0,1991,2014,9257
2007,31,39802,49262,798882,794630,4972,10.2,4388,9,111881,37837,74044,4.8,14.1,103378,30502,72876,3.8,13,8503,1.1,26,0,2640,2648,15622
2007,32,43196,54128,1188154,1167096,8755,16.5,6672,12.6,235439,92160,143279,7.9,20.2,193322,61044,132278,5.2,16.6,42117,3.6,33.2,0,4402,4425,30677
2007,33,28988,35282,564024,562569,3783,10.8,3507,10,79676,26500,53176,4.7,14.2,76765,22766,53999,4,13.6,2911,0.6,27.2,0,2247,2258,12747
2007,34,181110,215101,3627012,3612119,24484,11.4,23345,10.9,567996,204627,363369,5.7,15.7,538212,178977,359235,5,14.9,29784,0.8,29.8,0,15364,15430,84333
2007,35,33721,42035,645010,634926,4964,11.9,4028,9.7,118594,51351,67243,8.1,18.7,98425,29114,69311,4.6,15.5,20169,3.2,31,0,2523,2545,15042
2007,36,388016,459317,7525870,7504848,52285,11.4,47795,10.5,1119273,399779,719494,5.3,14.9,1077231,380076,697155,5.1,14.4,42042,0.5,28.8,0,31974,32180,183768
2007,37,157867,204583,3580651,3543769,25199,12.5,19544,9.7,591196,216575,374621,6.1,16.7,517432,165811,351621,4.7,14.6,73764,2.1,29.2,0,12255,12417,79453
2007,38,17241,20764,291387,286694,2268,11,1896,9.2,46719,18151,28568,6.3,16.3,37333,12017,25316,4.2,13,9386,3.3,26,0,1020,1031,6888
2007,39,183855,246750,4776925,4778471,24092,9.8,23504,9.5,679469,249354,430115,5.2,14.2,682561,211390,471171,4.4,14.3,-3092,-0.1,28.4,0,13912,14147,99677
2007,40,65807,83008,1299647,1285166,9523,11.6,7794,9.5,222819,78217,144602,6.1,17.3,193857,62662,131195,4.9,15.1,28962,2.2,30.2,0,5059,5105,32768
2007,41,82486,101070,1477829,1465205,12467,12.5,9863,9.9,231764,81924,149840,5.6,15.8,206516,66426,140090,4.5,14.1,25248,1.7,28.2,0,6237,6308,34317
2007,42,215319,278311,5193334,5165141,27162,9.8,25199,9.1,736555,251260,485295,4.9,14.3,680168,219639,460529,4.3,13.2,56387,1.1,26.4,0,14880,15079,95922
2007,44,23148,26977,441548,438274,2739,10.2,2719,10.1,62478,20913,41565,4.8,14.3,55930,17687,38243,4,12.8,6548,1.5,25.6,0,1759,1774,10337
2007,45,75381,97602,1640395,1627053,11797,12.3,9200,9.6,271644,103580,168064,6.4,16.7,244960,75834,169126,4.7,15.1,26684,1.6,30.2,0,6075,6163,38626
2007,46,20439,24153,326786,323587,2722,11.4,2221,9.3,48639,18100,30539,5.6,15,42240,14362,27878,4.4,13.1,6399,1.9,26.2,0,1330,1334,7515
2007,47,94202,126278,2491122,2473990,14426,11.5,11925,9.5,411586,136634,274952,5.5,16.6,377324,117306,260018,4.7,15.3,34262,1.3,30.6,0,7466,7563,50562
2007,48,352961,472592,8912562,8728947,60878,13.1,47486,10.2,1703985,638577,1065408,7.3,19.5,1336755,473166,863589,5.4,15.3,367230,4.2,30.6,0,29909,30264,221883
2007,49,50991,61499,1086897,1058342,9683,16.2,6385,10.7,206145,69213,136932,6.5,19.5,149035,51821,97214,4.9,14.1,57110,5.4,28.2,0,4054,4072,26620
2007,50,17269,20026,271546,266935,2065,10.4,1898,9.5,42352,13245,29107,5,15.9,33131,10808,22323,4,12.4,9221,3.5,24.8,0,1107,1115,5160
2007,51,138796,180508,3154523,3148296,21183,11.9,17706,9.9,516420,173460,342960,5.5,16.4,503968,158071,345897,5,16,12452,0.4,32,0,10676,10787,69637
2007,53,132258,162148,2496794,2450394,21386,13.4,17077,10.7,433339,150001,283338,6.1,17.7,340538,122848,217690,5,13.9,92801,3.8,27.8,0,10681,10750,58586
2007,54,28973,37391,578776,578482,3613,9.7,3446,9.2,85657,32061,53596,5.5,14.8,85070,25834,59236,4.5,14.7,587,0.1,29.4,0,2181,2220,14149
2007,55,106196,134280,2488791,2480751,13298,9.9,12395,9.3,329028,112690,216338,4.5,13.3,312948,93152,219796,3.8,12.6,16080,0.7,25.2,0,7355,7432,44963
2007,56,15959,18507,210065,205436,2384,13.1,1765,9.7,38468,13064,25404,6.4,18.7,29210,10462,18748,5.1,14.2,9258,4.5,28.4,0,1139,1147,5423
2008,1,73019,96486,1711938,1709161,9021,9.4,8496,8.8,235679,78033,157646,4.6,13.8,230127,73612,156515,4.3,13.5,5552,0.3,27,0,6294,6301,41058
2008,2,13620,16915,245872,243112,1866,11.1,1746,10.3,35964,11184,24780,4.6,14.8,30444,7418,23026,3.1,12.5,5520,2.3,25,0,1067,1068,5040
2008,4,94870,123996,2306175,2332330,15737,12.7,14434,11.7,357975,143411,214564,6.1,15.3,410285,115754,294531,5,17.6,-52310,-2.3,30.6,0,10311,10338,72597
2008,5,47638,61405,1025630,1024989,5790,9.4,5617,9.2,128512,45123,83389,4.4,12.5,127230,34038,93192,3.3,12.4,1282,0.1,24.8,0,4083,4093,23272
2008,6,626080,784244,13786342,13759399,90317,11.5,84726,10.8,2152947,780852,1372095,5.7,15.6,2099061,679405,1419656,4.9,15.3,53886,0.3,30.6,0,60263,60376,423357
2008,8,111369,136792,2077929,2053529,16923,12.4,15065,11.1,339618,124082,215536,6,16.5,290818,99306,191512,4.8,14.2,48800,2.3,28.4,0,9942,9957,57470
2008,9,67822,84152,1554969,1541486,7705,9.2,7263,8.7,231969,82890,149079,5.4,15,205002,55836,149166,3.6,13.3,26967,1.7,26.6,0,4964,4965,31220
2008,10,17928,22570,386950,383984,2346,10.4,2271,10.1,60762,22057,38705,5.7,15.8,54830,13301,41529,3.5,14.3,5932,1.5,28.6,0,1545,1545,7626
2008,11,15693,19768,476215,470367,1959,10,1592,8.1,63138,20413,42725,4.3,13.4,51441,14922,36519,3.2,10.9,11697,2.5,21.8,0,921,922,5425
2008,12,357235,445657,6982207,7027127,55874,12.5,59888,13.4,1087653,438851,648802,6.2,15.5,1177494,378039,799455,5.4,16.8,-89841,-1.3,31,0,44036,44134,240701
2008,13,158117,204597,3624577,3621424,24234,11.9,22529,11.1,574896,230575,344321,6.4,15.9,568589,198632,369957,5.5,15.7,6307,0.2,31.4,0,16029,16040,103091
2008,15,23779,30180,515252,514578,2682,8.9,2634,8.7,65288,22271,43017,4.3,12.7,63939,17511,46428,3.4,12.4,1349,0.3,24.8,0,1865,1867,11604
2008,16,34548,41251,538917,542729,4960,12,4886,11.8,77102,29499,47603,5.4,14.2,84726,27113,57613,5,15.6,-7624,-1.4,28.4,0,3421,3436,19573
2008,17,229355,289476,5452076,5391218,28904,10,27206,9.4,786080,263990,522090,4.9,14.6,664365,195246,469119,3.6,12.3,121715,2.3,24.6,0,17844,17869,111503
2008,18,104383,138124,2613041,2618152,12419,9,12206,8.8,334426,109834,224592,4.2,12.8,344648,100524,244124,3.8,13.2,-10222,-0.4,25.6,0,8462,8465,60263
2008,19,60088,77025,1314541,1302404,6542,8.5,6476,8.4,166697,47735,118962,3.7,12.8,142423,40941,101482,3.1,10.9,24274,1.9,21.8,0,4205,4208,23468
2008,20,56381,71153,1181227,1163951,6623,9.3,6155,8.7,168438,58171,110267,5,14.5,133886,39875,94011,3.4,11.5,34552,3,23,0,4245,4249,25770
2008,21,64999,85537,1556923,1545393,7656,9,7529,8.8,223874,86234,137640,5.6,14.5,200813,59576,141237,3.9,13,23061,1.5,26,0,5348,5363,39467
2008,22,74913,96073,1642397,1632858,9340,9.8,7881,8.3,239864,78498,161366,4.8,14.7,220788,61912,158876,3.8,13.5,19076,1.2,27,0,5698,5701,41181
2008,23,29928,36558,501599,498730,3486,9.5,3628,9.9,64890,20950,43940,4.2,13,59151,19685,39466,3.9,11.9,5739,1.1,23.8,0,2391,2392,12853
2008,24,99721,125183,2216556,2208713,12246,9.8,12153,9.7,313090,105240,207850,4.8,14.2,297404,96765,200639,4.4,13.5,15686,0.7,27,0,8314,8320,51798
2008,25,126041,157507,3069551,3059095,14100,9,13859,8.8,395209,131211,263998,4.3,12.9,374298,108168,266130,3.5,12.2,20911,0.7,24.4,0,9427,9428,57376
2008,26,160661,206121,3621613,3632206,19089,9.2,20500,9.9,511047,186014,325033,5.1,14.1,532232,172970,359262,4.8,14.7,-21185,-0.6,28.2,0,14159,14194,114176
2008,27,106379,133727,2523362,2524664,12785,9.6,12763,9.5,328071,116130,211941,4.6,13,330674,90305,240369,3.6,13.1,-2603,-0.1,26,0,8132,8134,54775
2008,28,43496,56654,943327,937864,5415,9.6,5082,9,130826,42786,88040,4.6,13.9,119899,37121,82778,4,12.8,10927,1.1,25.6,0,3834,3835,23353
2008,29,107921,139466,2472275,2456527,13534,9.7,13298,9.5,343134,122182,220952,5,14,311638,85085,226553,3.5,12.7,31496,1.3,25.4,0,9477,9485,51807
2008,30,28306,32974,358244,354528,3620,11,3350,10.2,52937,17672,35265,5,14.9,45504,15042,30462,4.2,12.8,7433,2.1,25.6,0,2228,2230,10452
2008,31,39504,49139,803842,799502,4420,9,4180,8.5,106542,33446,73096,4.2,13.3,97862,25558,72304,3.2,12.2,8680,1.1,24.4,0,2690,2690,14330
2008,32,43052,54401,1152134,1166078,7680,14.2,6876,12.7,178016,73985,104031,6.3,15.3,205904,56963,148941,4.9,17.7,-27888,-2.4,30.6,0,5165,5172,35240
2008,33,28633,34995,581568,570751,3272,9.3,3297,9.4,91079,28601,62478,5,16,69444,19063,50381,3.3,12.2,21635,3.8,24.4,0,2300,2301,12215
2008,34,178898,213398,3612588,3611828,21877,10.2,22372,10.5,513884,190090,323794,5.3,14.2,512364,157889,354475,4.4,14.2,1520,0,28.4,0,16178,16192,93201
2008,35,33694,42094,643502,640781,4457,10.6,4060,9.7,96301,36307,59994,5.7,15,90859,26935,63924,4.2,14.2,5442,0.8,28.4,0,2786,2787,17289
2008,36,390083,462573,7631075,7560255,49950,10.9,44280,9.6,1087814,389722,698092,5.2,14.4,946175,305505,640670,4,12.5,141639,1.9,25,0,32001,32046,197034
2008,37,157215,205088,3586356,3568566,21472,10.5,18986,9.3,509503,183510,325993,5.1,14.3,473923,138319,335604,3.9,13.3,35580,1,26.6,0,13662,13687,85577
2008,38,17220,20794,296785,293491,1976,9.5,1751,8.5,40256,11856,28400,4,13.7,33669,9317,24352,3.2,11.5,6587,2.2,23,0,1042,1044,7107
2008,39,180094,242764,4718073,4732154,20088,8.2,21674,8.9,601760,207482,394278,4.4,12.7,629923,198283,431640,4.2,13.3,-28163,-0.6,25.4,0,14538,14567,107028
2008,40,65998,83731,1321073,1306286,8675,10.4,7381,8.9,198961,69833,129128,5.3,15.2,169387,48577,120810,3.7,13,29574,2.2,26,0,5289,5298,30869
2008,41,82304,101153,1480792,1474066,10946,10.9,9993,9.9,205313,69960,135353,4.7,13.9,191860,57253,134607,3.9,13,13453,0.9,26,0,7066,7068,38487
2008,42,213904,278320,5234409,5195418,24642,8.9,22180,8,679247,224258,454989,4.3,13.1,601266,170966,430300,3.3,11.6,77981,1.5,23.2,0,15266,15283,100415
2008,44,22790,26596,435896,437647,2445,9.2,2705,10.1,54644,21176,33468,4.8,12.5,58145,15924,42221,3.6,13.3,-3501,-0.8,25,0,1782,1784,9441
2008,45,74677,97370,1646810,1637438,9735,10,9041,9.3,234924,76481,158443,4.7,14.3,216180,58023,158157,3.5,13.2,18744,1.1,26.4,0,6553,6557,37950
2008,46,20408,24248,334283,328717,2452,10.2,2195,9.1,46972,16245,30727,4.9,14.3,35840,11969,23871,3.6,10.9,11132,3.4,21.8,0,1484,1488,7767
2008,47,93562,126919,2488649,2481427,13124,10.4,11317,9,363590,131532,232058,5.3,14.7,349147,90423,258724,3.6,14.1,14443,0.6,28.2,0,8347,8359,59569
2008,48,355569,477408,9089163,8965385,54289,11.5,44394,9.4,1531317,564215,967102,6.3,17.1,1283762,394342,889420,4.4,14.3,247555,2.8,28.6,0,31688,31778,236001
2008,49,51438,62085,1100254,1090457,8139,13.2,7132,11.6,180241,56615,123626,5.2,16.5,160647,54124,106523,5,14.7,19594,1.8,29.4,0,4979,4981,32973
2008,50,17008,19751,273340,271705,1738,8.8,1859,9.4,32929,11783,21146,4.3,12.1,29659,9474,20185,3.5,10.9,3270,1.2,21.8,0,1196,1196,6548
2008,51,137995,179750,3146759,3140313,18451,10.3,17405,9.7,457846,154568,303278,4.9,14.6,444955,130190,314765,4.1,14.2,12891,0.4,28.4,0,11833,11861,64452
2008,53,132719,163243,2519162,2500683,19101,11.8,16652,10.3,363726,117563,246163,4.7,14.5,326767,103680,223087,4.1,13.1,36959,1.4,26.2,0,11563,11566,65699
2008,54,28403,36983,580108,577508,2964,8,3158,8.5,75203,22283,52920,3.9,13,70004,19026,50978,3.3,12.1,5199,0.9,24.2,0,2319,2319,11905
2008,55,104581,133086,2495796,2486070,11329,8.5,11581,8.7,295370,93785,201585,3.8,11.9,275918,80166,195752,3.2,11.1,19452,0.8,22.2,0,7752,7803,49409
2008,56,16024,18607,217222,213100,2113,11.4,1862,10.1,38090,12894,25196,6.1,17.9,29846,9677,20169,4.5,14,8244,3.9,28,0,1218,1219,5814
2009,1,70524,93739,1606114,1652062,7600,8,9566,10.1,176270,66022,110248,4,10.7,268166,65681,202485,4,16.2,-91896,-5.5,21.4,0,6776,6795,36358
2009,2,13358,16729,249063,246938,1725,10.3,1810,10.8,39444,12627,26817,5.1,16,35194,10682,24512,4.3,14.3,4250,1.7,28.6,0,1026,1046,5183
2009,4,89397,118165,2097445,2193642,12529,10.4,16892,14,272596,115668,156928,5.3,12.4,464989,149969,315020,6.8,21.2,-192393,-8.8,24.8,0,11579,11621,69331
2009,5,46526,60293,970638,995307,5273,8.7,5974,9.8,108725,42358,66367,4.3,10.9,158064,43504,114560,4.4,15.9,-49339,-5,21.8,0,4219,4231,23772
2009,6,606157,762701,12912329,13297759,77577,10.1,91590,11.9,1654745,637876,1016869,4.8,12.4,2425606,677747,1747859,5.1,18.2,-770861,-5.8,24.8,0,63142,63348,386028
2009,8,107662,132860,1970384,2017258,14088,10.5,16701,12.4,259895,101057,158838,5,12.9,353642,107879,245763,5.3,17.5,-93747,-4.6,25.8,0,10746,10763,64303
2009,9,65619,81706,1469020,1507848,6278,7.6,8040,9.7,153739,53337,100402,3.5,10.2,231395,56841,174554,3.8,15.3,-77656,-5.1,20.4,0,5181,5203,30935
2009,10,17342,21944,370001,376548,2009,9.1,2391,10.8,45610,20994,24616,5.6,12.1,58703,15800,42903,4.2,15.6,-13093,-3.5,24.2,0,1476,1478,7805
2009,11,15533,19709,477640,475991,1844,9.4,1724,8.8,60463,18725,41738,3.9,12.7,57165,13679,43486,2.9,12,3298,0.7,24,0,946,949,5856
2009,12,339946,427508,6477289,6704917,48745,11.2,61957,14.2,854841,371850,482991,5.5,12.7,1310098,367154,942944,5.5,19.5,-455257,-6.8,25.4,0,43157,43385,220478
2009,13,150365,196347,3401827,3497428,19496,9.8,25305,12.7,448952,200168,248784,5.7,12.8,640153,184490,455663,5.3,18.3,-191201,-5.5,25.6,0,17488,17594,111860
2009,15,23253,29682,484828,498122,2420,8.1,2754,9.2,50394,19829,30565,4,10.1,76982,18864,58118,3.8,15.5,-26588,-5.4,20.2,0,1870,1874,10565
2009,16,32482,39145,501090,518550,3733,9.3,5510,13.7,58593,24201,34392,4.7,11.3,93513,26044,67469,5,18,-34920,-6.7,22.6,0,3547,3547,16591
2009,17,222814,282000,5111220,5265268,24640,8.6,29750,10.4,546537,205037,341500,3.9,10.4,854634,219694,634940,4.2,16.2,-308097,-5.8,20.8,0,18639,18690,117007
2009,18,100939,134295,2445445,2520548,10301,7.6,12979,9.6,269356,92275,177081,3.7,10.7,419562,100493,319069,4,16.6,-150206,-5.9,21.4,0,8482,8555,51259
2009,19,58948,75865,1280277,1294757,5648,7.4,6428,8.4,144016,45495,98521,3.5,11.1,172976,38595,134381,3,13.4,-28960,-2.3,22.2,0,4209,4213,25031
2009,20,55092,69801,1135474,1155332,5501,7.8,6447,9.2,129590,42243,87347,3.7,11.2,169306,38758,130548,3.4,14.7,-39716,-3.5,22.4,0,4328,4336,25015
2009,21,63364,83934,1476656,1511357,6787,8,7733,9.2,164577,60999,103578,4,10.9,233979,55005,178974,3.6,15.5,-69402,-4.6,21.8,0,5279,5303,31038
2009,22,74090,95348,1624024,1629182,8013,8.4,8241,8.6,212634,72241,140393,4.4,13.1,222951,61248,161703,3.8,13.7,-10317,-0.6,26.2,0,5799,5800,35271
2009,23,28707,35295,480360,489844,2829,7.9,3819,10.7,50285,17388,32897,3.5,10.3,69252,17856,51396,3.6,14.1,-18967,-3.8,20.6,0,2405,2406,11566
2009,24,96099,121732,2115292,2158501,10583,8.6,12905,10.5,244511,85896,158615,4,11.3,330928,90312,240616,4.2,15.3,-86417,-4,22.6,0,8301,8334,46894
2009,25,121990,153349,2943783,2995642,12206,7.9,14927,9.6,307783,105418,202365,3.5,10.3,411501,107284,304217,3.6,13.7,-103718,-3.4,20.6,0,9422,9478,56086
2009,26,154151,198282,3369813,3485624,15866,7.9,22149,11,399242,141737,257505,4.1,11.5,630863,166002,464861,4.8,18.1,-231621,-6.6,23,0,13952,14007,98730
2009,27,103260,130570,2388608,2450341,11150,8.5,13400,10.2,269236,90519,178717,3.7,11,392704,90261,302443,3.7,16,-123468,-5,22,0,8015,8055,52682
2009,28,42307,55455,898024,917899,4556,8.2,5347,9.6,105258,45288,59970,4.9,11.5,145007,38714,106293,4.2,15.8,-39749,-4.3,23,0,3808,3826,22316
2009,29,104514,135837,2358071,2407579,11631,8.5,14340,10.4,272384,94532,177852,3.9,11.3,371399,105175,266224,4.4,15.4,-99015,-4.1,22.6,0,9853,9871,59735
2009,30,27177,31766,339757,348385,2870,8.9,3839,11.9,39800,12519,27281,3.6,11.4,57055,15501,41554,4.4,16.4,-17255,-5,22.8,0,2338,2338,9023
2009,31,39094,48679,781845,792171,3956,8.1,4149,8.5,86849,29737,57112,3.8,11,107501,30519,76982,3.9,13.6,-20652,-2.6,22,0,2614,2621,15198
2009,32,41151,52569,1038364,1090940,6536,12.3,7707,14.5,139075,59573,79502,5.5,12.7,244226,57458,186768,5.3,22.4,-105151,-9.7,25.4,0,5457,5489,36107
2009,33,27597,33891,555372,567793,2792,8.1,3609,10.5,59232,19585,39647,3.4,10.4,84074,21499,62575,3.8,14.8,-24842,-4.4,20.8,0,2346,2351,11836
2009,34,171370,205874,3400772,3494857,18690,8.9,24268,11.6,397042,145782,251260,4.2,11.4,585211,161668,423543,4.6,16.7,-188169,-5.3,22.8,0,16649,16687,94202
2009,35,32534,40983,616120,628084,3622,8.7,4397,10.6,76683,26465,50218,4.2,12.2,100611,27534,73077,4.4,16,-23928,-3.8,24.4,0,3056,3060,16379
2009,36,384117,456877,7340430,7468870,45585,9.9,48856,10.6,836950,307789,529161,4.1,11.2,1093830,292346,801484,3.9,14.6,-256880,-3.4,22.4,0,33420,33486,177896
2009,37,150143,198383,3352943,3453506,17571,8.7,22195,11,367303,148053,219250,4.3,10.6,568430,144829,423601,4.2,16.5,-201127,-5.9,21.2,0,15270,15322,80757
2009,38,17156,20709,294751,295225,1804,8.7,1816,8.8,37188,12513,24675,4.2,12.6,38135,11872,26263,4,12.9,-947,-0.3,25.2,0,1076,1077,7204
2009,39,173663,235657,4446442,4566727,17462,7.3,22438,9.4,485019,178509,306510,3.9,10.6,725589,187750,537839,4.1,15.9,-240570,-5.3,21.2,0,14494,14686,100829
2009,40,65330,83054,1282911,1298500,7413,8.9,7600,9.1,159995,57478,102517,4.4,12.3,191172,58634,132538,4.5,14.7,-31177,-2.4,24.6,0,5361,5370,35494
2009,41,78476,97334,1369506,1422327,8863,9,11686,11.8,155079,54746,100333,3.8,10.9,260721,62506,198215,4.4,18.3,-105642,-7.4,21.8,0,7849,7861,34902
2009,42,209552,273750,5031128,5117710,21015,7.6,23690,8.6,528463,177967,350496,3.5,10.3,701627,191707,509920,3.7,13.7,-173164,-3.4,20.6,0,15180,15323,98067
2009,44,21666,25377,410540,420722,1978,7.6,2914,11.2,44942,14188,30754,3.4,10.7,65306,19790,45516,4.7,15.5,-20364,-4.8,21.4,0,1888,1889,12393
2009,45,71485,94073,1534701,1585256,8245,8.6,10610,11.1,174494,74063,100431,4.7,11,275605,71041,204564,4.5,17.4,-101111,-6.4,22,0,7360,7443,40509
2009,46,20167,24013,329849,331403,2146,8.9,2261,9.4,40652,14299,26353,4.3,12.3,43760,12384,31376,3.7,13.2,-3108,-0.9,24.6,0,1453,1453,7932
2009,47,90349,123556,2308726,2389512,10511,8.4,12695,10.2,256968,96133,160835,4,10.8,418540,100049,318491,4.2,17.5,-161572,-6.7,21.6,0,8788,8831,58349
2009,48,351591,474486,8797645,8917242,48414,10.2,47719,10.1,1219295,480944,738351,5.4,13.7,1458488,395597,1062891,4.4,16.4,-239193,-2.7,27.4,0,32580,32789,214894
2009,49,48872,59797,1046710,1070651,6870,11.3,8588,14.1,141842,51015,90827,4.8,13.2,189723,56471,133252,5.3,17.7,-47881,-4.5,26.4,0,5799,5802,32533
2009,50,16404,19214,264377,268109,1560,8,1950,10,28700,11352,17348,4.2,10.7,36164,10305,25859,3.8,13.5,-7464,-2.8,21.4,0,1200,1206,5319
2009,51,133745,176291,3016354,3070185,16369,9.2,18380,10.4,369000,147387,221613,4.8,12,476662,126691,349971,4.1,15.5,-107662,-3.5,24,0,12241,12269,67347
2009,53,126798,157558,2383475,2444501,15242,9.5,19581,12.2,313847,101649,212198,4.2,12.8,435898,111520,324378,4.6,17.8,-122051,-5,25.6,0,13031,13050,64540
2009,54,27620,36381,570607,574293,2661,7.3,3081,8.4,67123,22327,44796,3.9,11.7,74494,17171,57323,3,13,-7371,-1.3,23.4,0,2178,2180,10686
2009,55,101407,129888,2365976,2422860,9774,7.4,12184,9.3,223533,74659,148874,3.1,9.2,337300,86217,251083,3.6,13.9,-113767,-4.7,18.4,0,7814,7830,47027
2009,56,15794,18414,207987,211331,1817,9.8,1903,10.3,28323,9010,19313,4.3,13.4,35010,9746,25264,4.6,16.6,-6687,-3.2,26.8,0,1299,1300,6130
2010,1,68644,91920,1558807,1577687,7261,7.9,8435,9.1,177026,61609,115417,3.9,11.2,214786,63838,150948,4,13.6,-37760,-2.4,22.4,0,5959,5989,40982
2010,2,13407,16864,251073,249729,1656,9.9,1478,8.8,34061,9172,24889,3.7,13.6,31372,7583,23789,3,12.6,2689,1,25.2,0,849,857,4241
2010,4,86670,115212,2036538,2059877,12295,10.6,14160,12.2,293632,123625,170007,6,14.3,340309,103267,237042,5,16.5,-46677,-2.2,28.6,0,9432,9489,55618
2010,5,45990,59907,961310,962585,5072,8.5,5276,8.8,117113,43113,74000,4.5,12.2,119664,33092,86572,3.4,12.4,-2551,-0.2,24.4,0,3608,3611,21384
2010,6,593995,749815,12403206,12597927,75347,10,82465,10.9,1593548,604642,988906,4.8,12.6,1982991,606824,1376167,4.8,15.7,-389443,-3.1,25.2,0,55238,55398,351608
2010,8,105727,130844,1922707,1943220,14266,10.8,15509,11.8,264888,101374,163514,5.2,13.6,305914,92281,213633,4.7,15.7,-41026,-2.1,27.2,0,9500,9512,50866
2010,9,64389,80444,1437697,1449346,6333,7.8,7103,8.8,155276,51749,103527,3.6,10.7,178573,47598,130975,3.3,12.3,-23297,-1.6,21.4,0,4558,4564,28378
2010,10,17084,21555,358772,363333,1923,8.9,2189,10.1,40883,15906,24977,4.4,11.3,50004,15443,34561,4.3,13.8,-9121,-2.5,22.6,0,1309,1309,6831
2010,11,15600,19937,476854,476184,1947,9.9,1628,8.2,57796,19626,38170,4.1,12.1,56455,13548,42907,2.8,11.9,1341,0.2,23.8,0,889,890,5876
2010,12,337121,423793,6415643,6430342,50610,11.9,52472,12.4,977735,398215,579520,6.2,15.2,1007134,333152,673982,5.2,15.7,-29399,-0.5,30.4,0,35233,35298,194953
2010,13,147156,192699,3311562,3347159,19108,9.9,21572,11.1,425633,163705,261928,4.9,12.7,496829,151064,345765,4.5,14.8,-71196,-2.1,25.4,0,14086,14123,87497
2010,15,22820,29225,475037,479460,2331,7.9,2640,9,56165,21378,34787,4.5,11.7,65011,19746,45265,4.1,13.6,-8846,-1.9,23.4,0,1672,1673,11076
2010,16,31675,38322,490341,494791,3849,10,4520,11.7,66194,23583,42611,4.8,13.4,75094,21202,53892,4.3,15.2,-8900,-1.8,26.8,0,2852,2863,12815
2010,17,219610,278575,4956426,5021091,24937,8.9,26714,9.6,551888,197387,354501,3.9,11,681218,193231,487987,3.8,13.6,-129330,-2.6,22,0,16011,16062,105320
2010,18,99121,132433,2388590,2410698,10112,7.6,11248,8.5,271203,83046,188157,3.4,11.2,315419,85683,229736,3.6,13.1,-44216,-1.9,22.4,0,7241,7256,52659
2010,19,58387,75442,1252807,1264115,5615,7.4,5758,7.6,130005,38250,91755,3,10.3,152621,40130,112491,3.2,12.1,-22616,-1.8,20.6,0,3581,3587,25286
2010,20,54356,69127,1105125,1118528,5459,7.9,5828,8.4,121330,40404,80926,3.6,10.8,148135,40839,107296,3.7,13.2,-26805,-2.4,21.6,0,3810,3822,21973
2010,21,62301,82975,1449066,1458603,6683,8,7206,8.7,171572,63311,108261,4.3,11.8,190645,51641,139004,3.5,13.1,-19073,-1.3,23.6,0,4695,4704,31692
2010,22,73600,95170,1582506,1600137,7919,8.3,7784,8.2,186359,66716,119643,4.2,11.6,221620,55163,166457,3.4,13.9,-35261,-2.3,23.2,0,5263,5277,35231
2010,23,28429,35100,472044,475522,3066,8.7,3150,9,51757,19801,31956,4.2,10.9,58712,17241,41471,3.6,12.3,-6955,-1.4,21.8,0,1879,1879,9128
2010,24,94694,120160,2069540,2090507,10591,8.8,11707,9.7,246698,83128,163570,4,11.8,288631,78340,210291,3.7,13.8,-41933,-2,23.6,0,7067,7094,40417
2010,25,120269,151887,2895571,2909550,12826,8.4,13323,8.8,331302,110412,220890,3.8,11.4,359259,91188,268071,3.1,12.3,-27957,-0.9,22.8,0,8287,8319,50587
2010,26,150464,194012,3281942,3316947,15465,7.9,18655,9.5,405877,130917,274960,3.9,12.2,475888,138622,337266,4.2,14.3,-70011,-2.1,24.4,0,11724,11738,79807
2010,27,102061,129479,2360956,2370970,11092,8.6,11622,9,273087,96293,176794,4.1,11.5,293116,87661,205455,3.7,12.4,-20029,-0.9,23,0,6821,6822,43416
2010,28,41750,54985,875751,883810,4488,8.2,4760,8.6,97141,35231,61910,4,11,113259,29538,83721,3.3,12.8,-16118,-1.8,22,0,3303,3310,18776
2010,29,103034,134293,2289335,2316596,12353,9.2,12837,9.5,260443,92721,167722,4,11.2,314965,82511,232454,3.6,13.6,-54522,-2.4,22.4,0,8549,8573,51126
2010,30,26818,31428,336230,337444,2934,9.3,3188,10.1,42104,15850,26254,4.7,12.5,44532,11690,32842,3.5,13.2,-2428,-0.7,25,0,1925,1925,7525
2010,31,39094,48825,770258,774459,4002,8.2,3750,7.7,80937,27373,53564,3.5,10.5,89338,20676,68662,2.7,11.5,-8401,-1,21,0,2260,2273,12293
2010,32,40154,51609,996409,1013759,6381,12.3,6840,13.2,145730,68520,77210,6.8,14.4,180430,49803,130627,4.9,17.8,-34700,-3.4,28.8,0,4729,4736,33006
2010,33,27227,33510,554894,554146,2808,8.4,2992,8.9,69046,21329,47717,3.8,12.5,67549,18151,49398,3.3,12.2,1497,0.3,24.4,0,1946,1952,10653
2010,34,167883,201744,3328972,3356475,18742,9.2,21815,10.7,401483,144567,256916,4.3,12,456491,148312,308179,4.4,13.6,-55008,-1.6,24,0,14077,14107,83572
2010,35,31697,40095,598749,606422,3397,8.4,4090,10.1,72141,24941,47200,4.1,11.9,87486,23395,64091,3.9,14.4,-15345,-2.5,23.8,0,2699,2700,15279
2010,36,385020,457962,7262800,7289493,47698,10.4,45395,9.9,887321,328047,559274,4.5,12.2,940707,293675,647032,4,12.9,-53386,-0.7,24.4,0,30689,30730,176548
2010,37,147691,195644,3254763,3292644,18275,9.3,19942,10.2,403191,153147,250044,4.7,12.2,478954,136647,342307,4.2,14.5,-75763,-2.3,24.4,0,12546,12592,72803
2010,38,17436,21035,296084,294633,1906,9.1,1565,7.5,35899,11176,24723,3.8,12.2,32996,8148,24848,2.8,11.2,2903,1,22.4,0,882,882,4124
2010,39,169612,231452,4331457,4374645,17144,7.4,19585,8.4,479202,166482,312720,3.8,11,565578,147509,418069,3.4,12.9,-86376,-1.9,22,0,12075,12100,87161
2010,40,64686,82509,1234501,1254842,7026,8.5,7298,8.8,143435,58615,84820,4.7,11.4,184119,50596,133523,4,14.7,-40684,-3.3,22.8,0,4920,4936,31119
2010,41,77234,96352,1354063,1357700,9368,9.7,9863,10.2,182964,61114,121850,4.5,13.5,190237,53680,136557,4,14,-7273,-0.5,27,0,6359,6390,35341
2010,42,206707,271214,4941507,4974870,20768,7.6,21890,8.1,556308,193902,362406,3.9,11.2,623033,183216,439817,3.7,12.5,-66725,-1.3,22.4,0,13604,13620,104727
2010,44,21253,25051,396054,402241,2197,8.7,2411,9.6,42678,17018,25660,4.2,10.6,55052,13465,41587,3.3,13.7,-12374,-3.1,21.2,0,1562,1562,8606
2010,45,70001,92663,1487529,1503464,8202,8.8,9212,9.9,183291,73143,110148,4.9,12.2,215161,55985,159176,3.7,14.3,-31870,-2.1,24.4,0,6162,6207,35018
2010,46,20182,24110,323829,325854,2129,8.9,2003,8.3,37467,13707,23760,4.2,11.5,41517,11910,29607,3.7,12.7,-4050,-1.2,23,0,1236,1236,7962
2010,47,88533,121689,2254965,2274073,10187,8.3,11186,9.2,272461,94269,178192,4.1,12,310679,87146,223533,3.8,13.7,-38218,-1.7,24,0,7576,7602,51949
2010,48,351144,475245,8661365,8711157,47715,10.1,44311,9.4,1209403,480698,728705,5.5,13.9,1308988,380434,928554,4.4,15,-99585,-1.1,27.8,0,29911,29989,217495
2010,49,48181,59069,1007388,1025011,6946,11.7,7362,12.4,130488,52678,77810,5.1,12.7,165734,48260,117474,4.7,16.2,-35246,-3.5,25.4,0,4742,4764,30372
2010,50,16241,19087,262130,263062,1524,8,1608,8.4,26288,9094,17194,3.5,10,28152,7490,20662,2.8,10.7,-1864,-0.7,20,0,983,989,4851
2010,51,131998,174558,2957039,2975066,15758,9,16565,9.5,376668,134655,242013,4.5,12.7,412722,127204,285518,4.3,13.9,-36054,-1.2,25.4,0,10270,10300,62862
2010,53,125117,155894,2308386,2341341,15481,9.9,16437,10.5,279479,110482,168997,4.7,11.9,345388,93340,252048,4,14.8,-65909,-2.9,23.8,0,10644,10679,53108
2010,54,26950,35818,557012,562693,2484,6.9,2876,8,64447,22383,42064,4,11.5,75808,20046,55762,3.6,13.5,-11361,-2,23,0,1902,1922,12503
2010,55,99792,128451,2316510,2336033,9617,7.5,10470,8.1,232556,77099,155457,3.3,10,271602,74997,196605,3.2,11.6,-39046,-1.6,20,0,6621,6626,43163
2010,56,15380,18014,196909,201465,1581,8.7,1888,10.4,23855,8642,15213,4.3,11.8,32967,8808,24159,4.4,16.4,-9112,-4.6,23.6,0,1189,1189,4948
2011,1,67341,90555,1561200,1555311,7363,8.1,8156,9,192375,63963,128412,4.1,12.4,180597,54150,126447,3.5,11.6,11778,0.8,23.2,0,5473,5497,29285
2011,2,13354,16971,252292,251965,1641,9.7,1520,9,31695,10066,21629,4,12.6,31040,8489,22551,3.4,12.3,655,0.3,24.6,0,878,883,4169
2011,4,85515,114209,2078150,2052749,12650,11.1,13107,11.5,316870,107097,209773,5.2,15.4,266068,90790,175278,4.4,13,50802,2.4,26,0,8594,8641,54528
2011,5,45413,59407,972344,965175,5180,8.7,5343,9,125115,41708,83407,4.3,13,110777,34238,76539,3.5,11.5,14338,1.5,23,0,3644,3659,20408
2011,6,592908,750726,12557394,12450712,80020,10.7,76450,10.2,1781459,589258,1192201,4.7,14.3,1568095,555120,1012975,4.5,12.6,213364,1.7,25.2,0,50787,50973,321808
2011,8,105017,130409,1944469,1929387,14610,11.2,14436,11.1,279981,94490,185491,4.9,14.5,249819,81573,168246,4.2,12.9,30162,1.6,25.8,0,8945,8955,48832
2011,9,63315,79365,1442760,1438631,6280,7.9,7023,8.8,163161,51799,111362,3.6,11.3,154902,48992,105910,3.4,10.8,8259,0.5,21.6,0,4438,4446,23926
2011,10,16875,21297,360098,359923,1948,9.1,2062,9.7,44303,14156,30147,3.9,12.3,43952,14266,29686,4,12.2,351,0.1,24.4,0,1252,1252,6488
2011,11,15713,20180,490859,483344,1870,9.4,1506,7.5,62612,18651,43961,3.9,13,47582,11523,36059,2.4,9.8,15030,3.2,19.6,0,841,841,6534
2011,12,338275,425837,6553087,6485000,53594,12.6,50271,11.9,1072473,405835,666638,6.3,16.5,936299,354432,581867,5.5,14.4,136174,2.1,28.8,0,33748,33839,192808
2011,13,145500,191263,3320504,3305941,19669,10.3,20169,10.5,464407,156431,307976,4.7,14,435282,158202,277080,4.8,13.2,29125,0.8,26.4,0,13293,13330,84073
2011,15,22446,28923,481289,477628,2345,8.1,2453,8.5,58263,19388,38875,4.1,12.2,50940,16417,34523,3.4,10.7,7323,1.5,21.4,0,1652,1656,9578
2011,16,30726,37398,484331,486641,3706,9.8,4403,11.7,62391,21357,41034,4.4,12.8,67011,21425,45586,4.4,13.8,-4620,-1,25.6,0,2747,2755,14233
2011,17,218623,278005,5018235,4977987,26492,9.5,25828,9.3,628869,200279,428590,4,12.6,548375,169418,378957,3.4,11,80494,1.6,22,0,15814,15992,97380
2011,18,97579,131257,2424292,2402297,10771,8.2,11070,8.4,295812,87942,207870,3.7,12.3,251821,77422,174399,3.2,10.5,43991,1.8,21,0,7184,7218,47501
2011,19,57884,75089,1269121,1259032,5846,7.8,5938,7.9,142258,41412,100846,3.3,11.3,122080,34198,87882,2.7,9.7,20178,1.6,19.4,0,3693,3702,19910
2011,20,53264,68422,1101859,1102037,5715,8.3,6108,8.9,133204,48074,85130,4.4,12.1,133560,39316,94244,3.6,12.1,-356,0,24.2,0,3990,3992,23215
2011,21,61147,82080,1452244,1448036,6670,8.1,7037,8.5,174533,54124,120409,3.7,12.1,166116,51467,114649,3.6,11.5,8417,0.6,23,0,4797,4809,30973
2011,22,73031,95089,1602163,1591199,8053,8.5,7875,8.3,210545,71291,139254,4.5,13.2,188616,53494,135122,3.4,11.9,21929,1.3,23.8,0,5397,5413,31395
2011,23,27945,34629,471011,470540,3024,8.7,3315,9.5,53624,18787,34837,4,11.4,52681,17219,35462,3.7,11.2,943,0.2,22.4,0,1938,1942,10398
2011,24,93518,119501,2098717,2080125,10898,9.1,10898,9.1,273697,91243,182454,4.4,13.2,236512,66994,169518,3.2,11.4,37185,1.8,22.8,0,6893,6897,38411
2011,25,119771,151773,2919715,2902201,13113,8.7,12505,8.3,330542,95260,235282,3.3,11.4,295514,82313,213201,2.8,10.2,35028,1.2,20.4,0,7768,7775,43433
2011,26,148960,192988,3379675,3325201,16824,8.7,17069,8.8,481563,127032,354531,3.8,14.5,372616,120433,252183,3.6,11.2,108947,3.3,22.4,0,10774,10805,72526
2011,27,101487,129277,2406389,2381190,11521,8.9,11350,8.8,287133,88015,199118,3.7,12.1,236737,72473,164264,3,9.9,50396,2.2,19.8,0,6877,6896,43415
2011,28,41192,54560,881499,877454,4447,8.1,4596,8.4,103093,36133,66960,4.1,11.7,95002,29290,65712,3.3,10.8,8091,0.9,21.6,0,3227,3233,18133
2011,29,101041,132829,2286463,2283538,12179,9.1,13061,9.8,259283,82702,176581,3.6,11.4,253433,74950,178483,3.3,11.1,5850,0.3,22.2,0,9156,9162,47610
2011,30,26392,31019,332659,334706,2997,9.6,3241,10.4,40882,12910,27972,3.9,12.2,44976,16628,28348,5,13.4,-4094,-1.2,24.4,0,1950,1959,11612
2011,31,38743,48640,762751,764961,4136,8.5,4079,8.4,88682,27896,60786,3.6,11.6,93101,34060,59041,4.5,12.2,-4419,-0.6,23.2,0,2529,2535,14068
2011,32,39976,51548,991546,992213,6414,12.5,6191,12,133390,47074,86316,4.7,13.4,134725,46263,88462,4.7,13.6,-1335,-0.2,26.8,0,4302,4329,32745
2011,33,26789,33086,545408,549322,2678,8.1,2953,8.9,57746,17243,40503,3.1,10.5,65574,18116,47458,3.3,11.9,-7828,-1.4,21,0,1956,1956,11261
2011,34,166434,200544,3343790,3329839,19744,9.8,20323,10.1,426367,139204,287163,4.2,12.8,398466,129097,269369,3.9,12,27901,0.8,24,0,13519,13549,73530
2011,35,31295,39861,599651,598807,3674,9.2,3754,9.4,74519,25722,48797,4.3,12.4,72831,19991,52840,3.3,12.2,1688,0.2,24.4,0,2534,2539,13212
2011,36,385900,459782,7371422,7304639,48865,10.7,45946,10,962630,324258,638372,4.4,13.2,829065,283796,545269,3.9,11.3,133565,1.9,22.6,0,30900,30946,168933
2011,37,145652,193775,3300509,3267945,18095,9.3,18778,9.7,429216,140332,288884,4.3,13.1,364087,113011,251076,3.5,11.1,65129,2,22.2,0,12422,12498,71543
2011,38,17675,21407,304927,300192,2157,10.2,1733,8.2,41004,13232,27772,4.4,13.7,31534,9113,22421,3,10.5,9470,3.2,21,0,1046,1048,5938
2011,39,167573,229142,4405836,4359573,17841,7.8,18798,8.2,552733,156878,395855,3.6,12.7,460208,135644,324564,3.1,10.6,92525,2.1,21.2,0,11674,11734,79480
2011,40,63904,82017,1253617,1241826,7282,8.9,7392,9,165902,51465,114437,4.1,13.4,142321,46823,95498,3.8,11.5,23581,1.9,23,0,5054,5068,29538
2011,41,76529,95706,1342408,1341346,9296,9.7,9462,9.9,174862,50774,124088,3.8,13,172740,49694,123046,3.7,12.9,2122,0.1,25.8,0,6141,6185,30200
2011,42,205157,270871,5027465,4973898,22011,8.1,20798,7.7,621016,198256,422760,4,12.5,513881,155158,358723,3.1,10.3,107135,2.2,20.6,0,13187,13217,85314
2011,44,20976,24825,405243,400085,2178,8.8,2314,9.3,49483,14960,34523,3.7,12.4,39167,12970,26197,3.2,9.8,10316,2.6,19.6,0,1450,1453,6674
2011,45,68511,91285,1502899,1492636,8015,8.7,8896,9.7,199641,64177,135464,4.3,13.4,179116,57088,122028,3.8,12,20525,1.4,24,0,5986,6003,36824
2011,46,20015,24025,321183,322135,2108,8.8,2131,8.9,37958,13650,24308,4.2,11.8,39861,13956,25905,4.3,12.4,-1903,-0.6,23.6,0,1354,1363,9874
2011,47,87089,120096,2285263,2265052,10317,8.6,11022,9.2,292028,81695,210333,3.6,12.9,251606,84773,166833,3.7,11.1,40422,1.8,22.2,0,7539,7605,47773
2011,48,351482,477956,8848400,8738982,49882,10.5,44755,9.4,1326006,459319,866687,5.3,15.2,1107171,341211,765960,3.9,12.7,218835,2.5,25.4,0,30525,30693,209338
2011,49,48138,59213,1018086,1011350,6974,11.8,6609,11.2,139705,50386,89319,5,13.8,126235,40532,85703,4,12.5,13470,1.3,25,0,4263,4282,26741
2011,50,15989,18796,262799,262103,1496,7.9,1722,9.1,27359,7509,19850,2.9,10.4,25967,8053,17914,3.1,9.9,1392,0.5,19.8,0,1069,1073,4711
2011,51,130448,173732,2987239,2965000,16575,9.5,16177,9.3,403217,134678,268539,4.5,13.6,358738,106229,252509,3.6,12.1,44479,1.5,24.2,0,10445,10469,60526
2011,53,122785,153704,2286131,2292801,15535,10.1,16816,10.9,312999,99247,213752,4.3,13.7,326339,116635,209704,5.1,14.2,-13340,-0.5,27.4,0,10833,10852,54942
2011,54,26318,35343,558863,556206,2631,7.4,2903,8.2,65746,18274,47472,3.3,11.8,60431,16974,43457,3.1,10.9,5315,0.9,21.8,0,2006,2007,11605
2011,55,98077,126861,2343912,2326290,9571,7.5,10577,8.3,259133,73151,185982,3.1,11.1,223888,64136,159752,2.8,9.6,35245,1.5,19.2,0,6642,6679,39761
2011,56,15443,18125,201029,199180,1854,10.3,1710,9.5,29377,9426,19951,4.7,14.7,25678,7943,17735,4,12.9,3699,1.8,25.8,0,1074,1074,4789
2012,1,67378,90749,1572076,1565292,7956,8.8,8052,8.9,203503,61585,141918,3.9,13,189935,59780,130155,3.8,12.1,13568,0.9,24.2,0,4910,4964,31192
2012,2,13528,17143,256383,254357,1751,10.3,1690,9.9,39844,12631,27213,5,15.7,35791,8599,27192,3.4,14.1,4053,1.6,28.2,0,812,819,3103
2012,4,86076,114835,2108657,2089869,12886,11.3,12677,11.1,330692,111796,218896,5.3,15.8,293116,100517,192599,4.8,14,37576,1.8,28,0,7445,7538,43888
2012,5,45629,59604,970507,971044,5179,8.7,5344,9,121907,35153,86754,3.6,12.6,122981,39497,83484,4.1,12.7,-1074,-0.1,25.2,0,3268,3306,19411
2012,6,603078,760647,12852113,12696623,84928,11.3,79164,10.5,1954550,624474,1330076,4.9,15.4,1643570,579774,1063796,4.6,12.9,310980,2.5,25.8,0,47190,47614,292277
2012,8,106360,131729,1999074,1970535,15085,11.5,14323,10.9,299438,99590,199848,5.1,15.2,242360,86243,156117,4.4,12.3,57078,2.9,24.6,0,8053,8130,42295
2012,9,63767,79856,1480818,1461204,7090,8.9,6884,8.7,197926,53330,144596,3.6,13.5,158698,50173,108525,3.4,10.9,39228,2.6,21.8,0,4002,4032,23168
2012,10,16837,21394,364762,362332,2186,10.3,2156,10.1,52387,18604,33783,5.1,14.5,47526,19881,27645,5.5,13.1,4861,1.4,26.2,0,1170,1177,6259
2012,11,15850,20150,496177,491127,1781,8.9,1762,8.8,65991,17890,48101,3.6,13.4,55891,15118,40773,3.1,11.4,10100,2,22.8,0,853,865,6657
2012,12,348108,436744,6761742,6655917,55951,13,48053,11.2,1123622,385846,737776,5.8,16.9,911971,383315,528656,5.8,13.7,211651,3.2,27.4,0,29592,29916,216540
2012,13,146776,192752,3367869,3338860,21247,11.1,20570,10.7,495521,172502,323019,5.2,14.8,437502,158893,278609,4.8,13.1,58019,1.7,26.2,0,11898,12003,69721
2012,15,22438,28805,492779,486811,2360,8.2,2587,9,61494,19705,41789,4,12.6,49557,17448,32109,3.6,10.2,11937,2.4,20.4,0,1433,1442,7590
2012,16,31071,37750,499623,492332,4073,10.9,4068,10.8,77296,26116,51180,5.3,15.7,62714,25538,37176,5.2,12.7,14582,3,25.4,0,2342,2367,10703
2012,17,220532,279567,5085175,5047524,27316,9.8,26918,9.7,682078,207350,474728,4.1,13.5,606776,208707,398069,4.1,12,75302,1.5,24,0,14714,14842,87597
2012,18,98308,132202,2517927,2478070,11788,9,11408,8.7,347943,104441,243502,4.2,14,268231,84871,183360,3.4,10.8,79712,3.2,21.6,0,6503,6606,42760
2012,19,58412,75814,1293675,1279865,6451,8.6,6121,8.1,161242,45145,116097,3.5,12.6,133622,47557,86065,3.7,10.4,27620,2.2,20.8,0,3427,3450,20056
2012,20,53598,68796,1124307,1113135,6145,9,6198,9,152736,52362,100374,4.7,13.7,130392,46381,84011,4.2,11.7,22344,2,23.4,0,3494,3547,20739
2012,21,61514,82626,1488126,1468866,7335,8.9,7261,8.8,207957,66280,141677,4.5,14.2,169437,53188,116249,3.6,11.5,38520,2.7,23,0,4245,4283,24124
2012,22,73720,96140,1632318,1617651,8717,9.1,8271,8.7,231472,70268,161204,4.3,14.3,202139,60783,141356,3.8,12.5,29333,1.8,25,0,4879,4925,32514
2012,23,27987,34764,480028,475162,3348,9.7,3356,9.7,63568,20050,43518,4.2,13.4,53835,18199,35636,3.8,11.3,9733,2.1,22.6,0,1885,1897,9707
2012,24,94896,120886,2147890,2122340,11523,9.6,10793,9,304285,95663,208622,4.5,14.3,253184,83223,169961,3.9,11.9,51101,2.4,23.8,0,6004,6063,33971
2012,25,121576,153473,2990737,2951273,14355,9.4,13160,8.6,379213,103761,275452,3.5,12.8,300284,97767,202517,3.3,10.2,78929,2.6,20.4,0,7358,7447,46167
2012,26,150772,194762,3471255,3424977,18044,9.3,17353,9,511450,148232,363218,4.3,14.9,418895,165737,253158,4.8,12.2,92555,2.7,24.4,0,9640,9768,83002
2012,27,102356,130120,2473012,2438271,11943,9.2,11613,9,325058,82141,242917,3.4,13.3,255577,82568,173009,3.4,10.5,69481,2.8,21,0,6143,6217,43337
2012,28,41087,54672,892750,888478,4532,8.3,4889,9,111538,33287,78251,3.7,12.6,102994,29748,73246,3.3,11.6,8544,1,23.2,0,3045,3061,16338
2012,29,101237,133060,2324566,2302996,13109,9.9,13311,10,304769,98813,205956,4.3,13.2,261628,82321,179307,3.6,11.4,43141,1.8,22.8,0,8365,8452,41404
2012,30,26894,31593,342178,337573,3421,10.9,3127,10,49646,16478,33168,4.9,14.7,40436,13401,27035,4,12,9210,2.7,24,0,1750,1766,7115
2012,31,39371,49280,786098,774528,4342,8.9,4094,8.4,104730,33944,70786,4.4,13.5,81589,24024,57565,3.1,10.5,23141,3,21,0,2274,2305,12451
2012,32,40449,51993,1020056,1004997,6534,12.7,6210,12,157241,59503,97738,5.9,15.6,127123,48456,78667,4.8,12.6,30118,3,25.2,0,3854,3904,29865
2012,33,27014,33398,542840,544809,3128,9.4,2955,8.9,66057,21788,44269,4,12.1,69994,29421,40573,5.4,12.8,-3937,-0.7,24.2,0,1756,1787,11090
2012,34,168365,202506,3398283,3369631,21306,10.6,20213,10,473853,138579,335274,4.1,14.1,416550,141098,275452,4.2,12.4,57303,1.7,24.8,0,12370,12449,64357
2012,35,31455,40050,598670,598155,3867,9.7,3909,9.8,82216,28900,53316,4.8,13.7,81186,27359,53827,4.6,13.6,1030,0.1,27.2,0,2290,2350,11823
2012,36,392482,466816,7546358,7453066,51181,11.1,45871,9.9,1016682,314410,702272,4.2,13.6,830099,277222,552877,3.7,11.1,186583,2.5,22.2,0,29210,29403,151185
2012,37,147107,195737,3375831,3331762,19473,10,18585,9.6,477938,143291,334647,4.3,14.3,389800,129551,260249,3.9,11.7,88138,2.6,23.4,0,10818,10900,64504
2012,38,18550,22446,326822,315991,2667,12.2,1873,8.5,57012,18980,38032,6,18,35350,12115,23235,3.8,11.2,21662,6.8,22.4,0,1073,1083,6842
2012,39,168385,230030,4512004,4450683,19616,8.6,19289,8.4,623377,172804,450573,3.9,14,500736,168360,332376,3.8,11.3,122641,2.7,22.6,0,10803,10926,80184
2012,40,64947,83282,1287560,1269766,8069,9.8,7397,9,190061,63741,126320,5,15,154474,50645,103829,4,12.2,35587,2.8,24.4,0,4430,4468,26127
2012,41,77480,96523,1373353,1357826,10162,10.6,9816,10.2,195953,63602,132351,4.7,14.4,164900,55322,109578,4.1,12.1,31053,2.3,24.2,0,5462,5504,27190
2012,42,206949,272438,5125486,5068632,22920,8.5,22237,8.2,670994,203648,467346,4,13.2,557285,176235,381050,3.5,11,113709,2.2,22,0,12661,12788,80922
2012,44,21092,24935,408177,406399,2371,9.5,2342,9.4,50910,16575,34335,4.1,12.5,47354,14318,33036,3.5,11.7,3556,0.8,23.4,0,1341,1353,6863
2012,45,69027,91933,1531872,1516933,8512,9.3,8381,9.2,210685,64757,145928,4.3,13.9,180808,56179,124629,3.7,11.9,29877,2,23.8,0,4973,5027,26998
2012,46,20332,24457,333490,327459,2392,9.9,2229,9.2,45989,16310,29679,5,14,33926,11250,22676,3.4,10.4,12063,3.6,20.8,0,1305,1314,5767
2012,47,87397,120700,2344198,2313389,11119,9.2,11104,9.2,321330,98200,223130,4.2,13.9,259712,87379,172333,3.8,11.2,61618,2.7,22.4,0,6677,6725,40712
2012,48,360046,488560,9237223,9057754,54277,11.2,46137,9.6,1478398,492905,985493,5.4,16.3,1119459,382665,736794,4.2,12.4,358939,3.9,24.8,0,27705,28066,184259
2012,49,49271,60531,1059448,1038760,7560,12.6,6633,11.1,169150,58345,110805,5.6,16.3,127774,44782,82992,4.3,12.3,41376,4,24.6,0,3934,3985,27304
2012,50,16095,18947,266179,264426,1764,9.4,1704,9,37396,9584,27812,3.6,14.1,33889,9922,23967,3.8,12.8,3507,1.3,25.6,0,988,998,5389
2012,51,131763,175013,3045697,3013598,16939,9.7,16412,9.4,455879,133256,322623,4.4,15.1,391682,126001,265681,4.2,13,64197,2.1,26,0,9214,9340,50511
2012,53,123813,154770,2327114,2305842,16648,10.8,16551,10.7,330690,105020,225670,4.6,14.3,288146,92793,195353,4,12.5,42544,1.8,25,0,9437,9523,45714
2012,54,26324,35374,573213,566076,2780,7.9,2969,8.4,78260,22798,55462,4,13.8,63986,21240,42746,3.8,11.3,14274,2.5,22.6,0,1728,1756,9358
2012,55,98228,127154,2380271,2360651,10699,8.4,10936,8.6,281038,80072,200966,3.4,11.9,241798,75235,166563,3.2,10.2,39240,1.7,20.4,0,6266,6334,36618
2012,56,15719,18433,206903,203897,1974,10.8,1833,10,34849,11677,23172,5.7,17.1,28837,11665,17172,5.7,14.1,6012,3,28.2,0,1047,1074,5037
2013,1,67120,90414,1590674,1578366,7649,8.5,7376,8.2,202257,61135,141122,3.9,12.8,177642,58972,118670,3.7,11.3,24615,1.5,22.6,0,5149,5167,34154
2013,2,13649,17279,263449,259516,1787,10.4,1563,9.1,35318,9732,25586,3.8,13.6,27452,7906,19546,3,10.6,7866,3,21.2,0,920,921,4691
2013,4,86925,115921,2145115,2120008,13037,11.3,11161,9.7,308852,106965,201887,5,14.6,258638,86433,172205,4.1,12.2,50214,2.4,24.4,0,7505,7546,49896
2013,5,45534,59584,972759,969712,5321,9,5036,8.5,116829,37067,79762,3.8,12,110734,37362,73372,3.9,11.4,6095,0.6,22.8,0,3543,3589,19696
2013,6,610090,767519,13311466,13047572,86689,11.4,75538,9.9,2073993,723030,1350963,5.5,15.9,1546204,558984,987220,4.3,11.9,527789,4,23.8,0,50956,51232,332253
2013,8,108034,133418,2052061,2020421,15709,11.9,13201,10,305236,98565,206671,4.9,15.1,241955,87413,154542,4.3,12,63281,3.1,24,0,8544,8576,50205
2013,9,63570,79695,1495007,1484709,6953,8.7,6669,8.4,168989,51307,117682,3.5,11.4,148393,47225,101168,3.2,10,20596,1.4,20,0,4285,4312,27722
2013,10,16991,21566,386861,374829,2170,10.1,1838,8.6,61902,24458,37444,6.5,16.5,37838,12039,25799,3.2,10.1,24064,6.4,20.2,0,1164,1171,5903
2013,11,16041,20492,500077,496654,2107,10.4,1599,7.9,59773,19604,40169,3.9,12,52927,18300,34627,3.7,10.7,6846,1.3,21.4,0,908,912,9054
2013,12,355363,444380,6909301,6820435,56568,12.9,46627,10.6,1065881,406684,659197,6,15.6,888149,335651,552498,4.9,13,177732,2.6,26,0,32282,32391,183110
2013,13,148117,194048,3423676,3383791,20721,10.8,18093,9.4,476320,147265,329055,4.4,14.1,396549,144668,251881,4.3,11.7,79771,2.4,23.4,0,12245,12285,80946
2013,15,22517,28870,499135,494671,2529,8.8,2273,7.9,58749,18669,40080,3.8,11.9,49820,18450,31370,3.7,10.1,8929,1.8,20.2,0,1480,1487,10482
2013,16,31278,37955,516133,506618,4141,11,3749,9.9,75398,24656,50742,4.9,14.9,56368,18829,37539,3.7,11.1,19030,3.8,22.2,0,2513,2517,13048
2013,17,220510,279614,5193989,5127996,27276,9.8,25546,9.2,693624,234823,458801,4.6,13.5,561638,191766,369872,3.7,11,131986,2.5,22,0,16092,16198,107370
2013,18,97743,131361,2537557,2514769,10597,8.1,10636,8.1,309130,88800,220330,3.5,12.3,263555,78341,185214,3.1,10.5,45575,1.8,21,0,7038,7066,48125
2013,19,57848,75436,1304973,1296871,5968,7.9,5880,7.8,141490,44277,97213,3.4,10.9,125285,40340,84945,3.1,9.7,16205,1.2,19.4,0,3752,3772,22503
2013,20,53274,68433,1149993,1134057,5857,8.6,5704,8.3,152433,53655,98778,4.7,13.4,120560,37896,82664,3.3,10.6,31873,2.8,21.2,0,3923,3941,24088
2013,21,61649,82878,1497421,1488005,7481,9.1,6658,8.1,194297,63632,130665,4.3,13.1,175464,59788,115676,4,11.8,18833,1.3,23.6,0,4528,4544,30496
2013,22,73739,96119,1664245,1643411,8210,8.6,7672,8,229584,67645,161939,4.1,14,187916,62561,125355,3.8,11.4,41668,2.6,22.8,0,5297,5317,39552
2013,23,27859,34593,477116,476827,3063,8.9,3019,8.7,54811,17440,37371,3.7,11.5,54232,19030,35202,4,11.4,579,0.1,22.8,0,1864,1877,11643
2013,24,95327,121673,2183225,2160967,11789,9.7,10299,8.5,291750,105637,186113,4.9,13.5,247233,79001,168232,3.7,11.4,44517,2.1,22.8,0,6524,6555,45747
2013,25,122271,154254,3050814,3015248,14032,9.1,12456,8.1,362731,115125,247606,3.8,12,291599,94916,196683,3.1,9.7,71132,2.3,19.4,0,7802,7881,50807
2013,26,150755,194277,3530549,3492614,16885,8.7,16268,8.4,449477,133966,315511,3.8,12.9,373608,111302,262306,3.2,10.7,75869,2.2,21.4,0,10451,10477,67986
2013,27,102452,130444,2506149,2485720,11636,9,10583,8.1,302889,89501,213388,3.6,12.2,262030,71739,190291,2.9,10.5,40859,1.7,21,0,6568,6573,45287
2013,28,40995,54540,894195,891096,4483,8.2,4264,7.8,101491,30464,71027,3.4,11.4,95292,26134,69158,2.9,10.7,6199,0.7,21.4,0,3101,3121,18761
2013,29,102534,134401,2361862,2337578,13956,10.5,11768,8.8,287477,83492,203985,3.6,12.3,238908,74444,164464,3.2,10.2,48569,2.1,20.4,0,8101,8166,44181
2013,30,27155,31873,354462,347416,3439,10.9,2980,9.4,50220,18867,31353,5.4,14.5,36128,11896,24232,3.4,10.4,14092,4.1,20.8,0,1916,1923,8336
2013,31,39360,49373,785130,783929,4297,8.7,3926,8,91561,28028,63533,3.6,11.7,89159,26328,62831,3.4,11.4,2402,0.3,22.8,0,2602,2613,14762
2013,32,41082,52669,1035135,1025129,6700,12.8,5646,10.8,155401,57138,98263,5.6,15.2,135388,50395,84993,4.9,13.2,20013,2,26.4,0,3995,4041,31136
2013,33,26918,33355,543781,542000,2891,8.7,2762,8.3,62957,19470,43487,3.6,11.6,59395,17603,41792,3.2,11,3562,0.6,22,0,1826,1830,10215
2013,34,169027,203404,3453093,3420251,21313,10.5,19475,9.6,485022,148327,336695,4.3,14.2,419338,144464,274874,4.2,12.3,65684,1.9,24.6,0,13151,13208,83524
2013,35,31329,39889,599479,597376,3702,9.3,3634,9.1,83446,28589,54857,4.8,14,79239,25627,53612,4.3,13.3,4207,0.7,26.6,0,2528,2550,15813
2013,36,395492,469038,7675572,7598369,50884,10.9,46816,10,1023049,354231,668818,4.7,13.5,868643,302500,566143,4,11.4,154406,2.1,22.8,0,31133,31321,179562
2013,37,147640,196747,3412512,3382241,19328,9.9,17071,8.7,461270,151151,310119,4.5,13.6,400728,124365,276363,3.7,11.8,60542,1.8,23.6,0,11768,11800,69561
2013,38,18920,22971,338539,331466,2590,11.4,1973,8.7,52275,17083,35192,5.2,15.8,38128,13527,24601,4.1,11.5,14147,4.3,23,0,1310,1310,8447
2013,39,167352,229040,4562676,4526457,18351,8,17727,7.8,576719,163163,413556,3.6,12.7,504281,152036,352245,3.4,11.1,72438,1.6,22.2,0,11461,11526,84158
2013,40,65471,83912,1317940,1299393,8004,9.6,6849,8.2,184872,64263,120609,4.9,14.2,147777,50290,97487,3.9,11.4,37095,2.8,22.8,0,4831,4861,34268
2013,41,78325,97496,1412617,1388914,10072,10.4,8477,8.8,195705,57996,137709,4.2,14.1,148298,49380,98918,3.6,10.7,47407,3.4,21.4,0,5732,5751,29861
2013,42,206561,272808,5130532,5115951,22848,8.4,20806,7.7,601455,192102,409353,3.8,11.8,572293,172482,399811,3.4,11.2,29162,0.6,22.4,0,13608,13652,100603
2013,44,20951,24852,414136,410548,2207,8.9,2193,8.8,47983,13468,34515,3.3,11.7,40807,13643,27164,3.3,9.9,7176,1.8,19.8,0,1395,1396,7961
2013,45,69392,92136,1563032,1542566,8478,9.2,7566,8.3,204563,64607,139956,4.2,13.3,163631,47370,116261,3.1,10.6,40932,2.7,21.2,0,5226,5273,28430
2013,46,20409,24523,334081,333213,2258,9.2,2082,8.5,40816,12723,28093,3.8,12.2,39079,14651,24428,4.4,11.7,1737,0.5,23.4,0,1383,1383,7754
2013,47,87599,120933,2392706,2362091,11048,9.2,9984,8.3,324564,94910,229654,4,13.7,263334,78161,185173,3.3,11.1,61230,2.6,22.2,0,6879,6946,45886
2013,48,366474,496333,9516467,9354398,54264,11.1,43465,8.9,1482563,493752,988811,5.3,15.8,1158424,398286,760138,4.3,12.4,324139,3.4,24.8,0,29827,29977,220621
2013,49,50425,61849,1085393,1069477,7627,12.5,5987,9.8,167219,60052,107167,5.6,15.6,135386,50528,84858,4.7,12.7,31833,2.9,25.4,0,3887,3901,32647
2013,50,15987,18821,261283,263365,1485,7.9,1534,8.1,33058,12684,20374,4.8,12.6,37221,18855,18366,7.2,14.1,-4163,-1.5,25.2,0,1000,1000,16069
2013,51,132609,176228,3099659,3063481,17407,9.9,14969,8.6,431628,154098,277530,5,14.1,359271,102501,256770,3.3,11.7,72357,2.4,23.4,0,9625,9653,57505
2013,53,125339,156222,2381306,2348157,17277,11.1,14769,9.5,329659,106995,222664,4.6,14,263360,94909,168451,4,11.2,66299,2.8,22.4,0,9925,9980,52389
2013,54,25843,34895,571431,570847,2558,7.3,2823,8.1,68796,22880,45916,4,12.1,67628,21681,45947,3.8,11.8,1168,0.3,23.6,0,1909,1918,11855
2013,55,97695,126568,2393816,2381740,10192,8.1,10021,7.9,259073,70466,188607,3,10.9,234920,68477,166443,2.9,9.9,24153,1,19.8,0,6437,6481,40253
2013,56,15666,18428,210460,208324,1871,10.2,1780,9.7,31370,10527,20843,5.1,15.1,27097,9239,17858,4.4,13,4273,2.1,26,0,1232,1235,6141
